#Version
1.8.0.0

#Width
15

#Height
12

#Sprite Water Layer
2,2,2,2,2,2,2,2,2,2,2,2,2,2,2
2,2,2,2,2,2,2,2,2,2,2,2,2,2,2
2,2,2,2,2,2,2,2,2,2,2,2,2,2,2
2,2,2,2,2,2,2,2,2,2,2,2,2,2,2
2,2,2,2,2,2,2,2,2,2,2,2,2,2,2
2,2,2,6,6,6,2,2,2,2,2,2,2,2,2
2,2,2,6,2,6,2,2,2,2,2,2,2,2,2
2,2,2,6,6,6,2,2,2,2,2,2,2,2,2
2,2,2,2,2,2,2,2,2,2,2,2,2,2,2
2,2,2,2,2,2,2,2,2,2,2,2,2,2,2
2,2,2,2,2,2,2,2,2,2,2,2,2,2,0
2,2,2,2,2,2,2,2,2,2,2,2,2,2,2

#Sprite Backgroud Layer
0,0,5,13,13,7,13,13,13,13,4,0,5,13,4
0,5,25,1,1,42,1,1,1,1,14,0,15,1,14
0,15,1,1,1,19,20,43,43,43,8,5,21,43,8
5,21,38,1,1,26,17,1,1,1,14,15,1,1,14
15,1,1,1,1,1,41,1,1,39,22,25,1,1,14
15,1,1,37,43,36,1,1,1,1,1,1,1,1,14
15,1,1,42,1,42,1,1,1,1,37,43,38,1,14
2,24,1,34,43,35,1,1,27,12,16,1,1,1,14
0,15,1,1,1,1,40,1,18,13,10,12,12,12,3
0,2,24,1,1,1,19,12,16,1,14,0,0,0,0
0,0,15,1,1,1,14,0,2,12,3,0,0,0,0
0,0,2,12,12,12,3,0,0,0,0,0,0,0,0

#Sprite Foregroud Layer
0,0,0,0,0,0,0,0,0,0,0,0,0,0,0
0,0,0,0,6,504,1,1,1,745,0,701,0,757,0
0,0,100,1,5,0,0,0,0,507,0,0,0,12,0
0,0,0,0,2,0,0,402,1,5,0,0,6,5,0
0,6,1,1,5,0,0,2,0,0,0,0,0,2,0
0,2,0,0,0,0,0,509,1,1,1,3,1,5,0
0,201,1,11,749,11,1,5,0,0,0,507,0,2,0
0,0,0,0,12,0,0,2,0,10,15,5,1,5,0
0,0,0,0,4,1,504,5,0,16,0,0,0,14,0
0,0,0,0,2,0,0,14,0,756,0,634,635,18,0
0,701,0,400,5,745,0,8,17,7,17,17,17,749,0
0,0,0,0,0,0,0,0,0,0,0,0,0,0,0

#Connections
0,0,0,0,0,0,0,0,0,0,0,0,0,0,0
0,0,0,0,5,12,2,2,2,6,0,0,0,1,0
0,0,2,2,7,2,2,2,2,15,0,0,0,1,0
0,0,0,0,1,0,0,5,2,3,0,0,2,7,0
0,0,0,0,1,0,0,1,0,0,0,0,0,1,0
0,5,2,2,3,0,0,9,2,2,2,10,2,7,0
0,4,2,2,10,2,2,7,0,0,0,15,0,1,0
0,0,0,0,1,0,0,1,0,5,2,8,2,7,0
0,0,0,0,9,2,12,7,0,1,0,0,0,1,0
0,0,0,0,1,0,0,1,0,1,0,0,0,1,0
0,0,0,2,8,2,0,4,2,2,2,2,2,3,0
0,0,0,0,0,0,0,0,0,0,0,0,0,0,0

#Tile Types
0,0,0,0,0,0,0,0,0,0,0,0,0,0,0
0,0,0,0,0,0,0,0,0,0,0,0,0,9,0
0,0,6,0,0,0,0,0,0,0,0,0,0,0,0
0,0,0,0,0,0,0,8,0,0,0,0,0,0,0
0,0,0,0,0,0,0,0,0,0,0,0,0,0,0
0,0,0,0,0,0,0,1,0,0,0,0,0,0,0
0,7,0,0,0,0,0,0,0,0,0,0,0,4,0
0,0,0,0,0,0,0,0,0,0,0,0,0,0,0
0,0,0,0,0,0,0,0,0,0,0,0,0,0,0
0,0,0,0,0,0,0,0,0,9,0,0,0,0,0
0,0,0,6,0,0,0,0,0,0,0,0,0,0,0
0,0,0,0,0,0,0,0,0,0,0,0,0,0,0

#Vehicle Boundaries
0,0,0,0,0,0,0,0,0,0,0,0,0,0,0
0,0,0,0,0,0,0,0,0,0,0,0,0,0,0
0,0,0,0,0,0,0,0,0,0,0,0,0,0,0
0,0,0,0,0,0,0,0,0,0,0,0,0,0,0
0,0,0,0,0,0,0,0,0,0,0,0,0,0,0
0,0,0,0,0,0,0,0,0,0,0,0,0,0,0
0,0,0,2,0,0,0,2,0,0,0,0,0,0,0
0,0,0,0,0,0,0,0,0,0,0,0,0,0,0
0,0,0,0,1,0,0,0,0,0,0,0,0,0,0
0,0,0,0,0,0,0,0,0,0,0,0,0,0,0
0,0,0,0,0,0,0,0,0,0,0,0,0,0,0
0,0,0,0,0,0,0,0,0,0,0,0,0,0,0

#Stages
#Stage Type 0,Map,Mode,Goal,Points,Bonus List(Max 10),Name,End World, then mode settings (see sample tour file for details)
#Stage Type 1,Bonus House Name,Sequential/Random Order,Display Text,Powerup List
4
0,0smw,16,5,3,1p20|1p15|1w3|2p0|2p4|3p1|3p19|3p6|3p8|4w1,1st Stop,0,1,5,0,8,4,1
0,Treefort,15,3,1,1p12,2nd Stop,1,3,310,0,2,1,1,0,0,1,0,0,1,0,0,0
0,Mountain waterfall,14,10,1,0,mountain waterfall,0
1,Toad's House,1,||Pick an item to help you on your way!||,p5,p7,w7,s1,s3

#Warps
#location 1 x, y, location 2 x, y
2
4,6,13,10
9,1,5,10

#Vehicles
#Sprite,Stage Type, Start Column, Start Row, Min Moves, Max Moves, Sprite Paces, Sprite Direction, Boundary
5
2,0,4,9,5,8,1,0,1
1,0,4,6,5,8,1,0,2
8,0,8,5,5,8,1,0,0
0,0,13,10,5,8,1,0,0
4,0,5,2,5,8,1,0,0

#Initial Items
w4,p12,p15,w0,w9,p6
