#Version
1.8.0.0

#Width
15

#Height
12

#Sprite Backgroud Layer
0,0,5,13,13,13,4,0,0,0,0,0,0,0,0
0,5,25,1,1,1,14,0,0,0,0,0,0,0,0
0,15,1,1,1,27,11,13,13,4,0,5,13,13,4
0,2,24,1,1,26,17,1,1,14,0,15,1,1,14
5,13,25,1,1,1,41,1,1,26,13,25,1,1,14
15,1,1,1,1,1,1,1,1,1,1,1,1,1,14
15,1,1,1,1,1,1,1,1,1,37,43,38,1,14
2,24,1,1,1,1,1,1,27,12,16,1,1,1,14
0,15,1,1,1,1,40,1,14,0,2,12,12,12,3
0,2,24,1,1,1,19,12,3,0,0,0,0,0,0
0,0,15,1,1,1,14,0,0,0,0,0,0,0,0
0,0,2,12,12,12,3,0,0,0,0,0,0,0,0

#Sprite Foregroud Layer
0,0,0,0,0,0,0,0,0,0,0,0,0,0,0
0,0,0,0,6,3,0,0,0,0,0,0,0,0,0
0,0,6,1,5,0,0,0,0,0,0,0,0,0,0
0,0,0,0,2,0,0,6,3,0,0,0,6,3,0
0,0,0,0,2,0,0,2,0,0,0,0,0,2,0
0,6,1,1,5,0,0,4,1,1,1,1,1,5,0
0,400,399,305,250,200,199,5,0,0,0,0,0,2,0
0,0,0,0,499,0,0,2,0,10,15,1,1,5,0
0,0,0,0,2,0,0,2,0,18,0,0,0,14,0
0,0,0,0,2,0,0,14,0,8,0,0,0,18,0
0,0,0,6,5,3,0,8,17,7,17,17,17,9,0
0,0,0,0,0,0,0,0,0,0,0,0,0,0,0

#Connections
0,0,0,0,0,0,0,0,0,0,0,0,0,0,0
0,0,0,0,5,2,0,0,0,0,0,0,0,0,0
0,0,2,2,7,0,0,0,0,0,0,0,0,0,0
0,0,0,0,1,0,0,5,2,0,0,0,2,6,0
0,0,0,0,1,0,0,1,0,0,0,0,0,1,0
0,5,2,2,3,0,0,9,2,2,2,2,2,7,0
0,4,2,2,10,2,2,7,0,0,0,0,0,1,0
0,0,0,0,1,0,0,1,0,5,2,2,2,7,0
0,0,0,0,1,0,0,1,0,1,0,0,0,1,0
0,0,0,0,1,0,0,1,0,1,0,0,0,1,0
0,0,0,2,8,2,0,4,2,2,2,2,2,3,0
0,0,0,0,0,0,0,0,0,0,0,0,0,0,0

#Tile Types
0,0,0,0,0,0,0,0,0,0,0,0,0,0,0
0,0,0,0,0,0,0,0,0,0,0,0,0,0,0
0,0,0,0,0,0,0,0,0,0,0,0,0,0,0
0,0,0,0,0,0,0,0,0,0,0,0,0,0,0
0,0,0,0,0,0,0,0,0,0,0,0,0,0,0
0,0,0,0,0,0,0,1,0,0,0,0,0,0,0
0,0,0,0,0,0,0,2,0,0,0,0,0,0,0
0,0,0,0,0,0,0,0,0,0,0,0,0,0,0
0,0,0,0,0,0,0,0,0,0,0,0,0,0,0
0,0,0,0,0,0,0,0,0,0,0,0,0,0,0
0,0,0,0,0,0,0,0,0,0,0,0,0,0,0
0,0,0,0,0,0,0,0,0,0,0,0,0,0,0

#Stages
#Map,Mode,Goal,Points,Bonus,Name,End World, then mode settings (see sample tour file for details)
3
0smw,16,5,1,20,1st Stop,0,1,5,0,8,4,1
Treefort,15,3,1,12,2nd Stop,1,3,310,0,2,1,1,0,0,1,0,0,1,0,0,0
Mountain waterfall,14,200,1,0,mountain waterfall,0

#Warps
#location 1 x, y, location 2 x, y
1
4,6,13,10

#Vehicles
#Sprite,Stage Type, Start Column, Start Row, Min Moves, Max Moves, Sprite Paces, Sprite Direction
4
0,0,2,5,3,8,1,0
8,1,7,1,6,10,1,0
2,2,5,9,1,3,0,1
4,0,7,10,10,15,1,1

