#Version
1.8.0.0

#Music Category
0

#Width
15

#Height
12

#Sprite Water Layer
2,2,2,2,2,2,2,2,2,2,2,2,2,2,2
2,2,2,2,2,2,2,2,2,2,2,2,2,2,2
2,2,2,2,2,2,2,2,2,2,2,2,2,2,2
2,2,2,2,2,2,2,2,2,2,2,2,2,2,2
2,2,2,2,2,2,2,2,2,2,2,2,2,2,2
2,2,2,6,6,6,2,2,2,2,2,2,2,2,2
2,2,2,6,2,6,2,2,2,2,2,2,2,2,2
2,2,2,6,6,6,2,2,2,2,2,2,2,2,2
2,2,2,2,2,2,2,2,2,2,2,2,2,2,2
2,2,2,2,2,2,2,2,2,2,2,2,2,2,2
2,2,2,2,2,2,2,2,2,2,2,2,2,2,0
2,2,2,2,2,2,2,2,2,2,2,2,2,2,2

#Sprite Background Layer
0,0,5,13,13,7,13,13,13,13,4,0,5,13,4
0,5,25,1,1,42,1,1,1,1,14,0,15,1,14
0,15,1,1,1,19,20,43,43,43,8,5,21,43,8
5,21,38,1,1,26,17,1,1,1,14,15,1,1,14
15,1,1,1,1,1,41,1,1,39,22,25,1,1,14
15,1,1,37,43,36,1,1,1,1,1,1,1,1,14
15,1,1,42,1,42,1,1,1,1,37,43,38,1,14
2,24,1,34,43,35,1,1,27,12,16,1,1,1,14
0,15,1,1,1,1,40,1,18,13,10,12,12,12,3
0,2,24,1,1,1,19,12,16,1,14,0,5,13,4
0,0,15,1,1,1,14,0,2,12,3,0,15,1,14
0,0,2,12,12,12,3,0,0,0,0,0,2,12,3

#Sprite Background Layer
0,0,0,0,0,0,0,0,0,0,0,0,0,0,0
0,0,0,0,6,604,1,1,1,846,0,801,0,857,0
0,0,200,1,5,0,0,0,0,607,0,0,0,12,0
0,0,0,0,2,0,0,502,1,5,0,0,0,2,0
0,6,1,1,5,0,0,2,0,0,0,0,0,2,0
0,2,0,0,0,0,0,609,1,1,1,3,1,5,0
0,301,1,11,845,11,1,5,0,0,0,606,0,0,0
0,0,0,0,0,0,0,0,0,10,15,5,1,3,0
0,0,0,0,6,1,605,3,0,16,0,0,0,14,0
0,0,0,0,2,0,0,14,0,856,0,634,639,16,0
0,801,0,403,5,846,0,8,17,7,17,17,15,845,0
0,0,0,0,0,0,0,0,0,0,0,0,0,0,0

#Connections
0,0,0,0,0,0,0,0,0,0,0,0,0,0,0
0,0,0,0,5,12,2,2,2,6,0,0,0,1,0
0,0,2,2,7,2,2,2,2,15,0,0,0,1,0
0,0,0,0,1,0,0,5,2,3,0,0,0,1,0
0,5,2,2,3,0,0,1,0,0,0,0,0,1,0
0,1,0,0,0,0,0,9,2,2,2,10,2,3,0
0,4,2,2,2,2,2,3,0,0,0,14,0,0,0
0,0,0,0,0,0,0,0,0,5,2,8,2,6,0
0,0,0,0,5,2,13,6,0,1,0,0,0,1,0
0,0,0,0,1,0,0,1,0,1,0,0,0,1,0
0,0,0,2,8,2,0,4,2,2,2,2,2,3,0
0,0,0,0,0,0,0,0,0,0,0,0,0,0,0

#Tile Types
0,0,0,0,0,0,0,0,0,0,0,0,0,0,0
0,0,0,0,0,0,0,0,0,0,0,0,0,11,0
0,0,6,0,0,0,0,0,0,0,0,0,0,0,0
0,0,0,0,0,0,0,8,0,0,0,0,0,3,0
0,0,0,0,0,0,0,0,0,0,0,0,0,0,0
0,0,0,0,0,0,0,1,0,0,0,0,0,0,0
0,7,0,0,0,0,0,0,0,0,0,0,0,0,0
0,0,0,0,0,0,0,0,0,0,0,0,0,0,0
0,0,0,0,0,0,0,0,0,0,0,0,0,0,0
0,0,0,0,0,0,0,0,0,11,0,0,0,0,0
0,0,0,9,0,0,0,0,0,0,0,0,0,0,0
0,0,0,0,0,0,0,0,0,0,0,0,0,0,0

#Vehicle Boundaries
0,0,0,0,0,0,0,0,0,0,0,0,0,0,0
0,0,0,0,1,0,0,0,0,0,0,0,0,0,0
0,0,0,0,0,0,0,0,0,0,0,0,0,0,0
0,0,0,0,0,0,0,0,0,0,0,0,0,0,0
0,0,0,0,0,0,0,0,0,0,0,0,0,0,0
0,0,0,0,0,0,0,2,0,0,0,0,0,2,0
0,1,0,0,0,0,0,0,0,0,0,0,0,0,0
0,0,0,0,0,0,0,0,0,0,0,0,0,0,0
0,0,0,0,1,0,0,0,0,0,0,0,0,0,0
0,0,0,0,0,0,0,0,0,0,0,0,0,0,0
0,0,0,0,0,0,0,0,0,0,0,0,0,0,0
0,0,0,0,0,0,0,0,0,0,0,0,0,0,0

#Stages
#Stage Type 0,Map,Mode,Goal,Points,Bonus List(Max 10),Name,End World, then mode settings (see sample tour file for details)
#Stage Type 1,Bonus House Name,Sequential/Random Order,Display Text,Powerup List
6
0,0smw,16,200,1,1w6,2nd Stop,0,5,0,8,4,1
0,Treefort,15,15,1,0,3rd Stop,0,3,310,0,0,1,1,0,0,1,0,0,1,0,0,0,0,0,0,0,0,0,0
0,Mountain waterfall,14,200,1,0,mountain waterfall,0
0,Ambitions of the Abyss,14,100,1,0,Lava Island,1
0,Blockfort,5,10,1,1p6,Vehicle Stop,0,60,10,5,0,1,0,0,1,0,0
1,Toad's House,1,|Pick a Powerup To|Help You On Your Way,p3,p2,p13

#Warps
#location 1 x, y, location 2 x, y
2
4,6,13,10
5,10,9,1

#Vehicles
#Sprite,Stage Type, Start Column, Start Row, Min Moves, Max Moves, Sprite Paces, Sprite Direction, Boundary
2
0,4,4,4,5,8,1,0,1
2,4,11,5,5,8,1,0,2

#Initial Items
p19,p20,p21,p22,p23,p24,p25,p26,p27,p28,p29
