#Level map
#Use this file to create an entire level of games and bonuses

#version
1.8.0.0

#Width
20

#Height
15

#Tile Sprites
0,0,0,0,0,0,0,1,0,0,0,0,0,0,0,0,0,0,0,0
0,0,0,0,0,0,0,3,0,0,0,0,0,0,0,0,0,0,0,0
0,0,0,0,0,0,0,3,4,3,4,0,0,0,0,0,0,0,0,0
0,0,0,0,0,0,0,3,0,0,3,0,0,0,0,0,0,0,0,0
0,0,0,0,0,0,0,3,0,0,4,3,4,0,0,0,0,0,0,0
0,0,0,0,0,0,0,3,0,0,3,0,0,0,0,0,0,0,0,0
1,3,3,3,3,3,3,3,3,3,1,3,3,3,3,3,3,3,3,1
0,0,0,0,0,3,0,3,0,0,3,0,0,0,0,0,0,0,0,0
0,0,0,0,0,3,0,3,0,0,3,0,0,0,0,0,0,0,0,0
0,0,0,0,0,3,0,3,4,3,4,3,5,0,0,0,0,0,0,0
0,0,0,0,0,3,0,3,0,0,0,0,0,0,0,0,0,0,0,0
0,0,0,0,0,4,3,3,0,0,0,0,0,0,0,0,0,0,0,0
0,0,0,0,0,0,0,3,0,0,0,0,0,0,0,0,0,0,0,0
0,0,0,0,0,0,0,3,0,0,0,0,0,0,0,0,0,0,0,0
0,0,0,0,0,0,0,1,0,0,0,0,0,0,0,0,0,0,0,0

#Connections
#1 == |  2 == -  3 == -!  4 == L  5 == ,-  6 == -,
#7 == -|  8 == -`-  9 == |-  10 == -,-  11 == +
0,0,0,0,0,0,0,1,0,0,0,0,0,0,0,0,0,0,0,0
0,0,0,0,0,0,0,1,0,0,0,0,0,0,0,0,0,0,0,0
0,0,0,0,0,0,0,1,2,2,6,0,0,0,0,0,0,0,0,0
0,0,0,0,0,0,0,1,0,0,1,0,0,0,0,0,0,0,0,0
0,0,0,0,0,0,0,1,0,0,9,2,2,0,0,0,0,0,0,0
0,0,0,0,0,0,0,1,0,0,1,0,0,0,0,0,0,0,0,0
2,2,2,2,2,10,2,11,2,2,11,2,2,2,2,2,2,2,2,2
0,0,0,0,0,1,0,1,0,0,1,0,0,0,0,0,0,0,0,0
0,0,0,0,0,1,0,1,0,0,1,0,0,0,0,0,0,0,0,0
0,0,0,0,0,1,0,1,2,2,8,2,2,0,0,0,0,0,0,0
0,0,0,0,0,1,0,1,0,0,0,0,0,0,0,0,0,0,0,0
0,0,0,0,0,4,2,7,0,0,0,0,0,0,0,0,0,0,0,0
0,0,0,0,0,0,0,1,0,0,0,0,0,0,0,0,0,0,0,0
0,0,0,0,0,0,0,1,0,0,0,0,0,0,0,0,0,0,0,0
0,0,0,0,0,0,0,1,0,0,0,0,0,0,0,0,0,0,0,0

#Tile Types
#1 == start, 2 on up are the world stages
0,0,0,0,0,0,0,0,0,0,0,0,0,0,0,0,0,0,0,0
0,0,0,0,0,0,0,0,0,0,0,0,0,0,0,0,0,0,0,0
0,0,0,0,0,0,0,0,0,0,3,0,0,0,0,0,0,0,0,0
0,0,0,0,0,0,0,0,0,0,0,0,0,0,0,0,0,0,0,0
0,0,0,0,0,0,0,0,0,0,2,0,2,0,0,0,0,0,0,0
0,0,0,0,0,0,0,0,0,0,0,0,0,0,0,0,0,0,0,0
0,0,0,0,0,0,0,0,0,0,1,0,0,0,0,0,0,0,0,0
0,0,0,0,0,0,0,0,0,0,0,0,0,0,0,0,0,0,0,0
0,0,0,0,0,0,0,0,0,0,0,0,0,0,0,0,0,0,0,0
0,0,0,0,0,0,0,0,2,0,2,0,2,0,0,0,0,0,0,0
0,0,0,0,0,0,0,0,0,0,0,0,0,0,0,0,0,0,0,0
0,0,0,0,0,3,0,0,0,0,0,0,0,0,0,0,0,0,0,0
0,0,0,0,0,0,0,0,0,0,0,0,0,0,0,0,0,0,0,0
0,0,0,0,0,0,0,0,0,0,0,0,0,0,0,0,0,0,0,0
0,0,0,0,0,0,0,0,0,0,0,0,0,0,0,0,0,0,0,0

#Stages
#Map,Mode,Goal,Points,Bonus,Name,End World, then mode settings (see sample tour file for details)
#Need to support other types of stop locations like bonuses, wheel spins, mini games (maybe)
#Need to support flagging each stop as a potential world end
#Need to support awarding players with a specific or random or none powerup at end of each level (probably in a dropped treasure box)
0smw,16,5,1,7,1st Stop,0,1,5,0,8,4,1
treefort,15,3,1,12,2nd Stop,1,3,310,0,2,1,1,0,0,1,0,0,1,0,0,0,0
