#Version
1.8.0.0

#Music Category
0

#Width
20

#Height
15

#Sprite Water Layer
0,0,0,0,0,0,0,0,0,0,0,0,0,0,0,0,0,0,0,0
0,0,0,0,0,0,0,0,0,0,0,0,0,0,0,0,0,0,0,0
0,0,0,0,0,0,0,0,0,0,0,0,0,0,0,0,0,0,0,0
0,0,0,0,0,0,0,0,0,0,0,0,0,0,0,0,0,0,0,0
0,0,0,0,0,0,0,0,0,0,0,0,0,0,0,0,0,0,0,0
0,0,0,0,0,0,0,0,0,0,0,0,0,0,0,0,0,0,0,0
0,0,0,0,0,0,0,0,0,0,0,0,0,0,0,0,0,0,0,0
0,0,0,0,0,0,0,0,0,0,0,0,0,0,0,0,0,0,0,0
0,0,0,0,0,0,0,0,0,0,0,0,0,0,0,0,0,0,0,0
0,0,0,0,0,0,0,0,0,0,0,0,0,0,0,0,0,0,0,0
0,0,0,0,0,0,0,0,0,0,0,0,0,0,0,0,0,0,0,0
0,0,0,0,0,0,0,0,0,0,0,0,0,0,0,0,0,0,0,0
0,0,0,0,0,0,0,0,0,0,0,0,0,0,0,0,0,0,0,0
0,0,0,0,0,0,0,0,0,0,0,0,0,0,0,0,0,0,0,0
0,0,0,0,0,0,0,0,0,0,0,0,0,0,0,0,0,0,0,0

#Sprite Backgroud Layer
1,1,1,1,1,1,1,1,1,1,1,14,0,135,121,121,121,121,121,121
1,1,1,1,1,1,1,1,1,1,27,3,125,145,121,121,121,121,121,121
1,1,1,1,1,1,1,1,27,12,3,0,135,121,121,121,121,121,121,121
1,1,1,1,1,27,12,12,3,0,0,0,135,121,121,121,121,147,132,132
1,1,1,1,27,3,0,0,0,0,0,0,135,121,121,121,147,123,365,373
1,1,1,27,3,0,0,0,0,0,0,0,122,132,132,132,123,365,385,361
1,27,12,3,0,0,0,305,313,313,313,313,313,304,0,0,0,375,361,361
12,3,0,0,0,0,305,325,301,301,301,301,301,314,0,0,365,385,361,361
253,244,0,0,0,305,325,301,301,301,301,301,301,314,0,0,375,361,361,361
241,266,244,0,0,315,301,301,301,301,301,301,301,314,0,365,385,361,361,361
241,241,254,0,0,315,301,301,327,312,312,312,312,303,0,375,361,361,361,361
241,277,262,253,244,302,312,312,303,0,0,0,0,0,0,375,361,361,361,361
241,282,241,241,266,253,253,253,253,253,253,253,253,244,0,362,384,361,361,361
241,282,241,241,241,241,241,241,241,241,241,241,241,266,253,244,362,384,361,361
252,256,241,241,241,241,241,241,241,241,241,241,241,241,241,254,0,362,384,361

#Sprite Foregroud Layer
901,901,901,0,0,0,0,901,0,0,0,0,789,0,0,810,810,810,810,810
901,609,1,1,200,3,0,0,0,901,0,0,0,0,106,101,101,202,810,810
901,901,901,901,0,700,0,901,0,0,0,0,0,909,102,810,810,703,0,810
901,901,730,731,901,775,0,0,0,0,0,0,0,106,201,0,909,775,0,789
6,1,742,743,0,0,0,0,0,789,0,0,0,102,909,0,0,0,0,0
307,901,901,775,0,0,734,735,0,0,0,0,0,775,0,0,0,0,0,915
4,775,0,0,0,0,0,0,0,756,0,0,0,0,0,0,0,775,61,63
789,0,0,0,789,0,0,0,146,768,141,143,0,0,0,789,0,0,0,62
0,0,0,0,0,0,0,912,142,708,709,409,0,0,0,0,0,0,796,503
0,0,0,0,0,775,141,408,145,720,721,145,0,0,0,0,0,915,66,65
0,911,0,789,0,0,912,0,0,0,0,0,0,0,0,0,915,796,62,915
911,0,0,0,0,0,0,0,0,0,0,789,0,0,0,0,0,732,504,0
0,130,121,728,775,0,0,0,0,0,0,0,0,0,0,0,775,744,65,796
811,306,0,911,0,0,0,811,911,126,121,123,121,775,0,0,0,0,0,0
0,128,811,121,121,911,121,305,121,125,0,811,911,0,0,0,789,789,0,796

#Connections
0,0,0,0,0,0,0,0,0,0,0,0,0,0,0,0,0,0,0,0
0,2,2,2,2,6,0,0,0,0,0,0,0,0,5,2,2,6,0,0
0,0,0,0,0,1,0,0,0,0,0,0,0,0,1,0,0,1,0,0
0,0,0,0,0,1,2,2,2,2,6,0,0,5,3,0,0,3,0,0
5,2,2,6,0,0,0,0,0,0,1,0,0,1,0,0,0,1,0,0
1,0,0,1,0,0,0,0,0,0,4,2,2,1,0,0,0,1,0,0
4,2,0,2,2,6,0,0,0,0,0,0,0,0,0,0,0,2,2,6
0,1,0,0,0,1,0,0,5,2,2,6,0,0,0,0,0,0,0,1
0,1,0,0,0,1,0,0,1,0,0,1,0,0,0,0,0,0,0,1
0,4,6,0,0,2,2,2,3,0,2,3,0,0,0,0,0,0,5,3
0,0,1,0,0,0,0,0,0,0,0,0,0,0,0,0,0,0,1,0
0,0,4,2,2,0,0,0,0,0,0,0,0,0,0,0,0,0,1,0
0,5,2,2,2,0,0,0,0,0,0,0,0,0,0,1,2,2,3,0
0,1,0,0,0,0,0,0,0,5,2,2,2,2,4,3,0,0,0,0
0,4,2,2,2,2,2,2,2,3,0,0,0,0,0,0,0,0,0,0

#Tile Types
0,0,0,0,0,0,0,0,0,0,0,0,0,0,0,0,0,0,0,0
0,1,0,0,6,0,0,0,0,0,0,0,0,0,0,0,0,9,0,0
0,0,0,0,0,7,0,0,0,0,0,0,0,0,0,0,0,10,0,0
0,0,0,0,0,0,0,0,0,0,0,0,0,0,8,0,0,0,0,0
0,0,0,19,0,0,0,0,0,0,0,0,0,0,0,0,0,0,0,0
18,0,0,0,0,0,0,0,0,0,0,0,0,0,0,0,0,0,0,0
0,0,0,0,0,0,0,0,0,0,0,0,0,0,0,0,0,0,0,0
0,0,0,0,0,0,0,0,0,21,0,0,0,0,0,0,0,0,0,0
0,0,0,0,0,0,0,0,0,0,0,22,0,0,0,0,0,0,0,11
0,0,0,0,0,0,0,20,0,0,23,0,0,0,0,0,0,0,0,0
0,0,0,0,0,0,0,0,0,0,0,0,0,0,0,0,0,0,0,0
0,0,0,0,0,0,0,0,0,0,0,0,0,0,0,0,0,0,12,0
0,0,0,17,0,0,0,0,0,0,0,0,0,0,0,0,0,13,0,0
0,16,0,0,0,0,0,0,0,0,0,0,0,0,0,0,0,0,0,0
0,0,15,0,0,0,0,14,0,0,0,0,0,0,0,0,0,0,0,0

#Vehicle Boundaries
0,0,0,0,0,0,0,0,0,0,0,0,0,0,0,0,0,0,0,0
0,0,0,0,0,0,0,0,0,0,0,0,0,0,0,0,0,0,0,0
0,0,0,0,0,0,0,0,0,0,0,0,0,0,0,0,0,0,0,0
0,0,0,0,0,100,0,0,0,0,0,0,0,0,0,0,0,100,0,0
0,0,0,0,0,0,0,0,0,0,0,0,0,0,0,0,0,0,0,0
0,0,0,100,0,0,0,0,0,0,0,0,0,100,0,0,0,0,0,0
0,100,0,0,0,0,0,0,0,0,0,0,0,0,0,0,0,100,0,0
0,0,0,0,0,0,0,0,0,0,0,0,0,0,0,0,0,0,0,0
0,0,0,0,0,0,0,0,0,0,0,0,0,0,0,0,0,0,0,0
0,0,0,0,0,100,0,0,0,0,0,0,0,0,0,0,0,0,0,0
0,0,0,0,0,0,0,0,0,0,0,0,0,0,0,0,0,0,0,0
0,0,0,0,0,0,0,0,0,0,0,0,0,0,0,0,0,0,0,0
0,0,0,0,100,0,0,0,0,0,0,0,0,0,0,0,100,0,0,0
0,0,0,0,0,0,0,0,0,0,0,0,0,100,0,0,0,0,0,0
0,0,0,0,0,0,0,0,0,0,0,0,0,0,0,0,0,0,0,0

#Stages
#Stage Type 0,Map,Mode,Goal,Points,Bonus List(Max 10),Name,End World, then mode settings (see sample tour file for details)
#Stage Type 1,Bonus House Name,Sequential/Random Order,Display Text,Powerup List
18
0,Plains of old,7,3,1,0,Level 1,0,0,0,1,0,0
0,Ancient castle,16,10,1,0,Castle 1,0,0,0,1,40,2,1
0,Green Pastures,0,15,1,0,Level 2,0,0
0,Grassy Canyon,6,50,1,0,Level 3,0,1,2,1,2,2,1,2,1,0
0,Golden Fort,17,50,3,1p4,Castle 2,0,620
0,Into the darkness,18,5,1,0,Level 4,0,4,6,10
0,Dark mountain,14,100,1,0,Level 5,0
0,The Dark Tower,16,15,1,0,Castle 3,0,1,1,1,40,2,1
0,Icy Plateau,5,20,1,0,Level 6,0,80,4,3,1,2,2,2,1,2
0,Ice Spire,13,3,1,0,Ice Spire,0,8,6,0
0,Ice Flow,18,5,1,0,Level 7,0,4,6,10
0,Shiver Spire,12,100,1,0,Castle 4,0,4,310,1
0,Forest fun,5,20,1,0,Level 8,0,80,4,3,1,2,2,2,1,2
0,Guardian Fortress,16,15,1,0,Castle 5,0,1,1,1,40,2,1
0,Starry Path,19,3,1,0,Level 9,0,3,0,50
0,Tower of light,20,100,1,0,Tower of light,0,5,1,0,0
0,Corrupted Road,18,3,1,0,Level 10,0,4,6,10
0,Death Castle,16,30,3,0,Final Castle,1,1,1,1,40,2,1

#Warps
#location 1 x, y, location 2 x, y
5
5,3,13,5
17,3,17,6
16,12,13,13
4,12,1,6
3,5,5,9

#Vehicles
#Sprite,Stage Type, Start Column, Start Row, Min Moves, Max Moves, Sprite Paces, Sprite Direction, Boundary
5
4,0,6,3,5,8,1,0,0
5,0,17,4,5,8,1,0,0
4,0,15,12,5,8,1,0,0
4,0,4,11,5,8,1,0,0
5,0,3,6,5,8,1,0,0

#Initial Items
w1,w2,w3,w4
