#Version
1.8.0.2

#Music Category
5

#Width
27

#Height
19

#Sprite Water Layer
0,0,0,0,0,0,0,0,0,0,0,0,0,0,0,0,0,0,0,0,0,0,0,0,0,0,0
0,0,0,0,0,0,0,0,0,0,0,0,0,0,0,0,0,0,0,0,0,0,0,0,0,0,0
0,0,0,0,0,0,0,0,0,0,0,0,0,0,0,0,0,0,0,0,0,0,0,0,0,0,0
0,0,0,0,0,0,0,0,0,0,0,0,0,0,0,0,0,0,0,0,0,0,0,0,0,0,0
0,0,0,0,0,0,0,0,0,0,0,0,0,0,0,0,0,0,0,0,0,0,0,0,0,0,0
0,0,0,0,0,0,0,0,0,0,0,0,0,0,0,0,0,0,0,0,0,0,0,0,0,0,0
0,0,0,0,0,0,0,0,0,0,0,0,0,0,0,0,0,0,0,0,0,0,0,0,0,0,0
0,0,0,0,0,0,0,0,0,0,0,0,0,0,0,0,0,0,0,0,0,0,0,0,0,0,0
0,0,0,0,0,0,0,0,0,0,0,0,0,0,0,0,0,0,0,0,0,0,0,0,0,0,0
0,0,0,0,0,0,0,0,0,0,0,0,0,0,0,0,0,0,0,0,0,0,0,0,0,0,0
0,0,0,0,0,0,0,0,0,0,0,0,0,0,0,0,0,0,0,0,0,0,0,0,0,0,0
0,0,0,0,0,0,0,0,0,0,0,0,0,0,0,0,0,0,0,0,0,0,0,0,0,0,0
0,0,0,0,0,0,0,0,0,0,0,0,0,0,0,0,0,0,0,0,0,0,0,0,0,0,0
0,0,0,0,0,0,0,0,0,0,0,0,0,0,0,0,0,0,0,0,0,0,0,0,0,0,0
0,0,0,0,0,0,0,0,0,0,0,0,0,0,0,0,0,0,0,0,0,0,0,0,0,0,0
0,0,0,0,0,0,0,0,0,0,0,0,0,0,0,0,0,0,0,0,0,0,0,0,0,0,0
0,0,0,0,0,0,0,0,0,0,0,0,0,0,0,0,0,0,0,0,0,0,0,0,0,0,0
0,0,0,0,0,0,0,0,0,0,0,0,0,0,0,0,0,0,0,0,0,0,0,0,0,0,0
0,0,0,0,0,0,0,0,0,0,0,0,0,0,0,0,0,0,0,0,0,0,0,0,0,0,0

#Sprite Background Layer
241,241,241,241,241,241,241,241,241,266,253,253,244,0,0,0,0,0,255,241,241,241,241,241,241,241,241
241,241,241,267,252,252,264,241,241,241,241,241,266,253,253,244,0,0,255,241,241,241,241,241,241,241,241
241,241,267,243,0,0,242,264,241,241,241,241,241,241,241,266,253,244,242,252,252,252,264,241,241,241,241
241,241,254,0,0,0,0,255,241,241,241,241,241,241,241,241,241,266,253,244,0,0,242,264,241,241,241
241,241,254,0,0,0,0,255,241,241,241,241,241,241,241,241,241,241,241,266,253,253,244,242,264,241,241
241,241,266,244,0,0,245,265,241,241,241,241,241,241,241,241,241,241,241,241,241,241,254,0,255,241,241
241,241,241,266,253,253,265,241,241,241,241,241,241,241,241,241,241,241,241,241,241,241,266,244,242,264,241
241,241,241,241,241,241,241,241,241,241,241,241,241,241,241,241,241,241,241,241,241,241,241,254,0,242,252
241,241,241,241,241,241,241,241,241,241,241,241,241,241,241,241,241,241,241,241,241,241,241,266,244,0,0
241,241,241,241,241,241,241,241,241,241,241,241,241,241,241,241,241,241,241,241,241,241,241,241,254,0,0
241,241,241,241,241,241,241,241,241,241,241,241,241,241,241,241,241,241,241,241,241,241,241,241,266,244,0
241,241,241,241,241,241,241,241,241,241,241,241,241,241,241,267,252,264,241,241,241,241,241,241,241,266,253
241,241,241,241,241,241,241,241,241,241,241,241,241,241,267,243,0,242,264,241,241,241,241,241,241,241,241
241,241,241,241,241,241,241,241,241,241,241,241,241,241,254,0,0,0,255,241,241,241,241,241,241,241,241
252,252,252,264,241,241,241,241,241,241,241,241,241,241,266,244,0,245,265,241,241,241,241,241,241,241,241
0,0,0,242,252,264,241,241,241,241,241,241,241,241,241,266,253,265,241,241,241,241,241,241,241,241,241
0,0,0,0,0,242,264,241,241,241,241,241,241,241,241,241,241,241,241,241,241,241,241,241,267,252,252
0,0,0,0,0,0,242,264,241,241,241,241,241,241,241,241,241,241,241,241,241,241,267,252,243,0,0
0,0,0,0,0,0,0,255,241,241,241,241,241,241,241,241,241,241,267,252,252,252,243,0,0,0,0

#Sprite Foreground Layer
0,908,0,908,0,907,0,0,911,0,0,0,0,0,789,0,0,0,0,811,0,787,0,811,787,0,749
908,858,0,0,0,0,0,907,0,0,911,0,0,0,0,0,0,789,0,0,46,309,43,0,0,811,761
0,42,0,0,789,0,0,0,0,0,0,0,911,0,0,0,0,0,0,0,54,0,48,41,728,41,45
907,42,0,0,0,789,0,0,907,0,0,0,0,0,911,0,0,0,0,0,308,789,0,0,0,787,0
0,44,775,775,775,301,775,775,41,41,41,43,0,0,0,0,0,911,0,0,56,0,0,0,0,0,811
0,907,0,0,0,58,0,0,0,0,0,42,0,913,0,0,0,0,0,0,42,0,0,789,0,787,0
0,0,0,0,0,56,0,0,0,913,0,302,0,0,0,913,0,0,911,0,42,0,0,0,0,0,787
0,912,0,0,0,42,0,912,0,0,0,44,41,41,41,41,43,41,913,41,45,0,0,0,789,0,0
0,0,0,912,0,44,41,41,41,43,0,0,0,0,0,0,42,0,42,0,0,0,911,0,0,0,0
0,0,0,0,0,0,0,0,0,42,0,911,0,0,912,0,304,0,42,0,0,0,0,0,0,789,0
0,0,609,41,41,300,41,41,41,757,41,41,41,861,0,0,42,0,44,41,41,307,41,43,0,0,789
912,0,0,0,0,42,0,0,0,42,0,0,0,0,0,0,776,0,0,0,0,0,0,42,797,0,0
0,0,0,912,0,42,0,912,0,42,0,912,0,0,0,0,776,0,0,0,0,912,0,42,785,797,809
0,0,0,0,0,857,0,0,0,42,0,0,0,0,0,0,776,779,779,41,305,0,0,42,797,809,797
0,0,0,0,0,0,0,0,0,44,41,736,0,0,0,0,776,0,0,0,42,0,909,42,909,797,809
0,0,0,0,0,0,0,912,0,0,912,42,0,912,0,0,776,0,0,909,42,0,906,42,906,904,809
0,734,735,0,0,0,0,0,0,0,0,44,41,41,41,41,303,0,0,0,42,906,904,306,0,0,0
0,0,0,0,0,0,0,0,0,0,0,0,0,0,0,0,0,0,906,904,44,41,53,49,0,0,0
0,0,0,0,0,0,0,0,0,0,912,0,0,0,0,909,0,904,0,0,0,0,0,0,0,0,0

#Connections
0,0,0,0,0,0,0,0,0,0,0,0,0,0,0,0,0,0,0,0,0,0,0,0,0,0,0
0,1,0,0,0,0,0,0,0,0,0,0,0,0,0,0,0,0,0,0,5,2,6,0,0,0,1
0,1,0,0,0,0,0,0,0,0,0,0,0,0,0,0,0,0,0,0,1,0,4,2,2,2,3
0,1,0,0,0,0,0,0,0,0,0,0,0,0,0,0,0,0,0,0,1,0,0,0,0,0,0
0,4,2,2,2,10,2,2,2,2,2,6,0,0,0,0,0,0,0,0,1,0,0,0,0,0,0
0,0,0,0,0,1,0,0,0,0,0,1,0,0,0,0,0,0,0,0,1,0,0,0,0,0,0
0,0,0,0,0,1,0,0,0,0,0,1,0,0,0,0,0,0,0,0,1,0,0,0,0,0,0
0,0,0,0,0,1,0,0,0,0,0,4,2,2,2,2,10,2,10,2,3,0,0,0,0,0,0
0,0,0,0,0,4,2,2,2,6,0,0,0,0,0,0,1,0,1,0,0,0,0,0,0,0,0
0,0,0,0,0,0,0,0,0,1,0,0,0,0,0,0,1,0,1,0,0,0,0,0,0,0,0
0,0,2,2,2,10,2,2,2,11,2,2,2,2,0,0,1,0,4,2,2,2,2,6,0,0,0
0,0,0,0,0,1,0,0,0,1,0,0,0,0,0,0,1,0,0,0,0,0,0,1,0,0,0
0,0,0,0,0,1,0,0,0,1,0,0,0,0,0,0,1,0,0,0,0,0,0,1,0,0,0
0,0,0,0,0,1,0,0,0,1,0,0,0,0,0,0,9,2,2,2,6,0,0,1,0,0,0
0,0,0,0,0,0,0,0,0,4,2,6,0,0,0,0,1,0,0,0,1,0,0,1,0,0,0
0,0,0,0,0,0,0,0,0,0,0,1,0,0,0,0,1,0,0,0,1,0,0,1,0,0,0
0,0,0,0,0,0,0,0,0,0,0,4,2,2,2,2,3,0,0,0,1,0,0,1,0,0,0
0,0,0,0,0,0,0,0,0,0,0,0,0,0,0,0,0,0,0,0,4,2,2,3,0,0,0
0,0,0,0,0,0,0,0,0,0,0,0,0,0,0,0,0,0,0,0,0,0,0,0,0,0,0

#Tile Types
0,0,0,0,0,0,0,0,0,0,0,0,0,0,0,0,0,0,0,0,0,0,0,0,0,0,0
0,23,0,0,0,0,0,0,0,0,0,0,0,0,0,0,0,0,0,0,0,20,0,0,0,0,22
0,0,0,0,0,0,0,0,0,0,0,0,0,0,0,0,0,0,0,0,0,0,0,0,21,0,0
0,0,0,0,0,0,0,0,0,0,0,0,0,0,0,0,0,0,0,0,19,0,0,0,0,0,0
0,0,0,0,0,8,0,0,0,0,0,0,0,0,0,0,0,0,0,0,0,0,0,0,0,0,0
0,0,0,0,0,0,0,0,0,0,0,0,0,0,0,0,0,0,0,0,0,0,0,0,0,0,0
0,0,0,0,0,0,0,0,0,0,0,10,0,0,0,0,0,0,0,0,0,0,0,0,0,0,0
0,0,0,0,0,0,0,0,0,0,0,0,0,0,0,0,0,5,18,0,0,0,0,0,0,0,0
0,0,0,0,0,0,0,0,0,0,0,0,0,0,0,0,0,0,0,0,0,0,0,0,0,0,0
0,0,0,0,0,0,0,0,0,0,0,0,0,0,0,0,12,0,0,0,0,0,0,0,0,0,0
0,0,1,0,0,6,0,0,0,7,0,0,0,25,0,0,0,0,0,0,0,17,0,0,0,0,0
0,0,0,0,0,0,0,0,0,0,0,0,0,0,0,0,0,0,0,0,0,0,0,0,0,0,0
0,0,0,0,0,0,0,0,0,0,0,0,0,0,0,0,0,0,0,0,0,0,0,0,0,0,0
0,0,0,0,0,24,0,0,0,0,0,0,0,0,0,0,0,0,0,0,13,0,0,0,0,0,0
0,0,0,0,0,0,0,0,0,0,0,9,0,0,0,0,0,0,0,0,0,0,0,0,0,0,0
0,0,0,0,0,0,0,0,0,0,0,0,0,0,0,0,0,0,0,0,0,0,0,0,0,0,0
0,0,0,0,0,0,0,0,0,0,0,0,0,0,0,0,11,0,0,0,0,0,0,15,0,0,0
0,0,0,0,0,0,0,0,0,0,0,0,0,0,0,0,0,0,0,0,0,0,0,0,0,0,0
0,0,0,0,0,0,0,0,0,0,0,0,0,0,0,0,0,0,0,0,0,0,0,0,0,0,0

#Vehicle Boundaries
0,0,0,0,0,0,0,0,0,0,0,0,0,0,0,0,0,0,0,0,0,0,0,0,0,0,0
0,0,0,0,0,0,0,0,0,0,0,0,0,0,0,0,0,0,0,0,0,0,0,0,0,0,0
0,0,0,0,0,0,0,0,0,0,0,0,0,0,0,0,0,0,0,0,0,0,0,0,0,0,0
0,0,0,0,0,0,0,0,0,0,0,0,0,0,0,0,0,0,0,0,0,0,0,0,0,0,0
0,0,0,0,0,0,0,0,0,0,0,0,0,0,0,0,0,0,0,0,0,0,0,0,0,0,0
0,0,0,0,0,0,0,0,0,0,0,0,0,0,0,0,0,0,0,0,0,0,0,0,0,0,0
0,0,0,0,0,0,0,0,0,0,0,0,0,0,0,0,0,0,0,0,0,0,0,0,0,0,0
0,0,0,0,0,0,0,0,0,0,0,0,0,0,0,0,0,0,0,0,0,0,0,0,0,0,0
0,0,0,0,0,0,0,0,0,0,0,0,0,0,0,0,0,0,0,0,0,0,0,0,0,0,0
0,0,0,0,0,0,0,0,0,0,0,0,0,0,0,0,0,0,0,0,0,0,0,0,0,0,0
0,0,0,0,0,0,0,0,0,0,0,0,0,0,0,0,0,0,0,0,0,1,0,0,0,0,0
0,0,0,0,0,0,0,0,0,0,0,0,0,0,0,0,0,0,0,0,0,0,0,0,0,0,0
0,0,0,0,0,0,0,0,0,0,0,0,0,0,0,0,0,0,0,0,0,0,0,0,0,0,0
0,0,0,0,0,0,0,0,0,0,0,0,0,0,0,0,1,0,0,0,0,0,0,0,0,0,0
0,0,0,0,0,0,0,0,0,0,0,0,0,0,0,0,0,0,0,0,0,0,0,0,0,0,0
0,0,0,0,0,0,0,0,0,0,0,0,0,0,0,0,0,0,0,0,0,0,0,0,0,0,0
0,0,0,0,0,0,0,0,0,0,0,0,0,0,0,0,0,0,0,0,0,0,0,0,0,0,0
0,0,0,0,0,0,0,0,0,0,0,0,0,0,0,0,0,0,0,0,0,0,0,0,0,0,0
0,0,0,0,0,0,0,0,0,0,0,0,0,0,0,0,0,0,0,0,0,0,0,0,0,0,0

#Stages
#Stage Type 0,Map,Mode,Goal,Points,Bonus List(Max 10),Name,End World, then mode settings (see sample tour file for details)
#Stage Type 1,Bonus House Name,Sequential/Random Order,Display Text,Powerup List
20
0,Nights Cruiser,1,10,1,0,Night Cruiser,0,0,0
0,Lunarbase,0,10,1,0,Lunar Base,0,0
0,Lunar Bridge,6,25,1,0,Lunar Bridge,0,0,0,0,4,0,0,0,4,0
0,Death Ship,16,20,2,1w4|1p9|2p10|3p8,Death Ship,0,120,0,0,3,4,1
0,Outer space thingie,11,300,1,0,Outer Space Thingy,0,10,1500,0,1,0
0,Big Dipper_,4,100,1,0,The Big Dipper,0,1,10
0,Somemoon,8,150,1,0,Moon's Surface,0,1,0
0,Space,10,2,1,0,Space,0,40,2,0
0,Space Pods,13,7,2,1w8,Space Pods,0,4,4,1
0,Lunar Jungle,15,20,1,0,Lunar Jungle,0,7,0,0,1,5,5,5,5,5,0,0,1,4,2,0,1,3,3,5,7,4,5
0,SpaceMy,5,15,1,0,SpaceMy,0,70,0,10,3,1,0,0,0,0,0
0,Abandoned Planet,14,222,1,0,Abandoned Planet,0
0,Spacemap,9,250,1,0,Space II,0,1
0,Lunar pool,3,12,1,0,Lunar Pool,0,0,500,1,0
0,Galaxy in a Pot,2,90,1,0,Pot Galaxy,0,0,0,0
0,Moonbase Madness,12,135,2,1p3,Moonbase Madness,0,3,2400,10
0,Orions Belt,0,20,3,0,Orion's Belt,1,0
1,Toad's House,1,||Pick an item to help you on your way!||,p7,p16,p17
1,Toad's House,1,||Pick an item to help you on your way!||,p7,p16,p17
1,Poison House,1,||Choose an item if you dare!||,p0,p0,w14

#Warps
#location 1 x, y, location 2 x, y
0

#Vehicles
#Sprite,Stage Type, Start Column, Start Row, Min Moves, Max Moves, Sprite Paces, Sprite Direction, Boundary
2
1,10,23,12,5,8,1,0,1
6,8,20,15,5,8,1,0,1

#Initial Items
w1,w3,w9,w10,p1,p15
