#Version
1.8.0.2

#Music Category
7

#Width
27

#Height
19

#Sprite Water Layer
6,6,6,6,6,6,6,6,6,6,6,6,6,6,6,6,6,6,6,6,6,6,6,6,6,6,6
0,0,0,0,0,0,0,0,0,0,0,0,0,0,0,0,0,0,0,0,0,0,0,0,0,0,0
6,6,0,0,0,0,0,0,0,0,0,0,0,0,0,0,0,0,0,0,0,0,0,0,0,0,0
6,6,0,0,0,0,0,0,0,0,0,0,0,0,0,0,0,0,0,0,0,0,0,0,0,0,0
6,6,0,0,0,0,0,0,0,0,0,0,0,0,0,0,0,0,0,0,0,0,0,0,0,0,0
6,6,0,0,0,0,0,0,0,0,0,6,6,6,6,6,6,6,6,6,0,0,0,0,0,0,0
6,6,6,6,6,0,6,6,6,6,6,6,6,6,6,6,6,6,6,6,6,6,6,6,6,6,6
0,0,0,0,6,0,6,0,0,0,0,0,0,0,0,0,0,0,0,6,6,6,6,6,6,6,6
0,0,0,0,0,0,0,0,0,0,0,0,0,0,0,0,0,0,0,6,6,6,6,6,6,6,6
0,0,0,0,0,0,0,0,0,0,0,0,0,0,0,0,0,0,0,0,0,0,0,0,0,0,0
0,0,0,0,0,0,0,0,0,0,0,0,0,0,0,0,0,0,0,0,0,0,0,0,0,0,0
0,0,0,0,0,0,0,0,0,0,0,0,0,0,0,0,0,0,0,0,0,0,0,0,0,0,0
0,0,0,0,0,0,0,0,0,0,0,0,0,0,0,0,0,0,0,0,0,0,0,0,0,0,0
0,0,0,0,0,0,0,0,0,0,0,0,0,0,0,0,0,0,0,0,0,0,0,0,0,0,0
0,0,0,0,0,0,0,0,0,0,0,0,0,0,0,0,0,0,0,0,0,0,0,0,0,0,0
0,0,0,0,0,0,0,0,0,0,0,0,0,0,0,0,0,0,0,0,0,0,0,0,0,0,0
0,0,0,0,0,0,0,0,0,0,0,0,0,0,0,0,0,0,0,0,0,0,0,0,0,0,0
0,0,0,0,0,0,0,0,0,0,0,0,0,0,0,0,0,0,0,0,0,0,0,0,0,0,0
0,0,0,0,0,0,0,0,0,0,0,0,0,0,0,0,0,0,0,0,0,0,0,0,0,0,0

#Sprite Background Layer
373,373,373,373,373,373,373,373,373,373,373,373,373,373,373,373,373,373,373,373,373,373,373,373,373,373,373
361,361,361,361,361,361,361,361,361,361,361,361,361,361,361,361,361,361,361,361,361,361,361,361,361,361,361
372,384,361,361,361,361,361,361,361,361,361,361,361,361,361,361,361,361,361,361,361,361,361,361,361,361,361
0,375,361,361,361,361,361,361,361,361,361,361,361,361,361,361,361,361,361,361,361,361,361,361,361,361,361
0,375,361,361,361,361,361,361,361,361,361,361,361,361,361,361,361,361,361,361,361,361,361,361,361,361,361
0,375,361,361,361,361,361,361,361,361,361,387,372,372,372,372,372,372,372,384,361,361,361,361,361,361,361
373,381,403,403,396,361,397,403,403,403,403,382,373,373,373,373,373,373,373,370,372,372,372,384,361,361,361
361,361,361,361,401,361,401,361,361,361,361,361,361,361,361,361,361,361,361,374,0,0,0,362,372,372,372
361,361,361,361,361,361,361,361,361,361,361,361,361,361,361,361,361,361,361,386,373,373,373,373,373,373,373
361,361,361,361,361,361,361,361,361,361,361,361,361,361,361,361,361,361,361,361,361,361,361,361,361,361,361
361,361,361,361,361,361,361,361,361,361,361,361,361,361,361,361,361,361,361,361,361,361,361,361,361,361,361
372,372,372,384,361,361,361,361,361,361,361,361,361,361,361,361,361,361,361,361,361,361,361,361,361,361,361
0,0,0,362,372,384,361,361,361,361,361,361,361,361,361,361,361,361,361,361,361,361,361,361,361,361,361
0,0,0,0,0,362,372,384,361,361,361,361,361,361,361,361,361,361,361,361,361,361,361,361,361,361,361
0,0,0,0,0,0,0,362,372,372,372,372,384,361,361,361,361,361,361,361,361,361,361,361,361,361,361
0,0,0,0,0,0,0,0,0,0,0,0,362,372,372,372,372,384,361,361,361,361,361,361,361,361,361
0,0,0,0,0,0,0,0,0,0,0,0,0,0,0,0,0,362,372,384,361,361,361,361,361,361,361
0,0,0,0,0,0,0,0,0,0,0,0,0,0,0,0,0,0,0,362,372,372,384,361,361,361,361
0,0,0,0,0,0,0,0,0,0,0,0,0,0,0,0,0,0,0,0,0,0,362,372,384,361,361

#Sprite Foreground Layer
710,710,710,710,710,710,710,710,710,710,710,710,710,710,710,710,710,710,710,710,710,710,710,710,710,710,710
722,722,722,722,722,722,722,722,722,722,722,722,722,722,722,722,722,722,722,722,722,722,722,722,722,722,722
0,0,0,915,0,913,0,802,0,807,0,807,0,807,0,807,0,807,802,807,0,909,0,0,802,749,905
0,0,860,141,141,143,141,141,724,141,141,141,141,141,306,141,141,141,141,307,141,141,143,0,0,761,906
0,0,915,0,0,142,0,0,0,807,0,807,802,807,0,807,0,807,0,807,909,0,142,0,909,142,906
0,0,0,913,802,142,915,0,915,0,915,711,711,711,711,0,0,0,0,0,0,802,308,141,141,922,905
710,710,710,710,0,142,0,710,710,710,710,723,723,723,723,711,711,711,711,0,0,0,0,0,0,0,802
722,722,722,722,0,305,0,722,722,722,722,723,723,723,723,723,723,723,723,711,711,711,711,0,0,0,0
800,0,915,0,0,142,0,915,0,0,913,0,913,915,913,723,723,723,723,723,723,723,723,711,711,711,711
0,801,0,0,916,142,0,0,146,141,141,304,141,141,141,141,921,143,913,723,723,723,723,723,723,723,723
0,0,0,0,0,142,802,0,142,916,0,142,0,916,0,0,915,142,0,0,0,913,913,723,723,723,723
0,802,0,0,801,144,141,141,145,0,0,856,802,0,0,915,0,144,141,302,0,802,0,915,0,0,915
0,0,0,0,0,0,0,800,142,0,801,0,0,146,141,921,141,145,0,142,916,146,141,141,141,300,0
0,0,0,0,0,0,0,0,142,0,0,0,801,142,711,711,711,711,916,142,0,142,0,0,916,142,0
0,0,0,802,0,0,0,0,148,157,303,157,155,145,723,723,723,723,0,144,141,301,0,800,0,142,916
0,0,0,0,0,0,0,0,0,0,158,0,0,0,0,0,0,0,802,0,801,0,802,0,0,142,0
0,0,0,0,0,0,0,802,0,0,158,0,0,0,0,802,0,0,0,0,0,0,0,801,0,609,800
0,802,0,0,0,0,0,0,0,0,923,0,0,0,0,0,0,0,0,0,0,0,0,0,0,0,0
0,0,0,0,0,0,0,0,0,0,0,0,802,0,0,0,0,0,0,0,0,0,0,0,802,0,801

#Connections
0,0,0,0,0,0,0,0,0,0,0,0,0,0,0,0,0,0,0,0,0,0,0,0,0,0,0
0,0,0,0,0,0,0,0,0,0,0,0,0,0,0,0,0,0,0,0,0,0,0,0,0,0,0
0,0,0,0,0,0,0,0,0,0,0,0,0,0,0,0,0,0,0,0,0,0,0,0,0,0,0
0,0,2,2,2,10,2,2,2,2,2,2,2,2,2,2,2,2,2,2,2,2,6,0,0,1,0
0,0,0,0,0,1,0,0,0,0,0,0,0,0,0,0,0,0,0,0,0,0,1,0,0,1,0
0,0,0,0,0,1,0,0,0,0,0,0,0,0,0,0,0,0,0,0,0,0,4,2,2,3,0
0,0,0,0,0,1,0,0,0,0,0,0,0,0,0,0,0,0,0,0,0,0,0,0,0,0,0
0,0,0,0,0,1,0,0,0,0,0,0,0,0,0,0,0,0,0,0,0,0,0,0,0,0,0
0,0,0,0,0,1,0,0,0,0,0,0,0,0,0,0,0,0,0,0,0,0,0,0,0,0,0
0,0,0,0,0,1,0,0,5,2,2,10,2,2,2,2,2,6,0,0,0,0,0,0,0,0,0
0,0,0,0,0,1,0,0,1,0,0,1,0,0,0,0,0,1,0,0,0,0,0,0,0,0,0
0,0,0,0,0,4,2,2,7,0,0,1,0,0,0,0,0,9,2,6,0,0,0,0,0,0,0
0,0,0,0,0,0,0,0,1,0,0,0,0,5,2,2,2,3,0,1,0,5,2,2,2,6,0
0,0,0,0,0,0,0,0,1,0,0,0,0,1,0,0,0,0,0,1,0,1,0,0,0,1,0
0,0,0,0,0,0,0,0,4,2,10,2,2,3,0,0,0,0,0,4,2,3,0,0,0,1,0
0,0,0,0,0,0,0,0,0,0,1,0,0,0,0,0,0,0,0,0,0,0,0,0,0,1,0
0,0,0,0,0,0,0,0,0,0,1,0,0,0,0,0,0,0,0,0,0,0,0,0,0,1,0
0,0,0,0,0,0,0,0,0,0,1,0,0,0,0,0,0,0,0,0,0,0,0,0,0,0,0
0,0,0,0,0,0,0,0,0,0,0,0,0,0,0,0,0,0,0,0,0,0,0,0,0,0,0

#Tile Types
0,0,0,0,0,0,0,0,0,0,0,0,0,0,0,0,0,0,0,0,0,0,0,0,0,0,0
0,0,0,0,0,0,0,0,0,0,0,0,0,0,0,0,0,0,0,0,0,0,0,0,0,0,0
0,0,0,0,0,0,0,0,0,0,0,0,0,0,0,0,0,0,0,0,0,0,0,0,0,0,0
0,0,21,0,2,0,0,0,14,0,0,0,0,0,15,0,0,0,0,16,0,0,0,0,0,19,0
0,0,0,0,0,0,0,0,0,0,0,0,0,0,0,0,0,0,0,0,0,0,0,0,0,0,0
0,0,0,0,0,0,0,0,0,0,0,0,0,0,0,0,0,0,0,0,0,0,17,0,0,18,0
0,0,0,0,0,0,0,0,0,0,0,0,0,0,0,0,0,0,0,0,0,0,0,0,0,0,0
0,0,0,0,0,13,0,0,0,0,0,0,0,0,0,0,0,0,0,0,0,0,0,0,0,0,0
0,0,0,0,0,0,0,0,0,0,0,0,0,0,0,0,0,0,0,0,0,0,0,0,0,0,0
0,0,0,0,0,0,0,0,0,0,0,12,0,0,0,0,9,0,0,0,0,0,0,0,0,0,0
0,0,0,0,0,0,0,0,0,0,0,0,0,0,0,0,0,0,0,0,0,0,0,0,0,0,0
0,0,0,0,0,0,0,0,0,0,0,20,0,0,0,0,0,0,0,8,0,0,0,0,0,0,0
0,0,0,0,0,0,0,0,0,0,0,0,0,0,0,10,0,0,0,0,0,0,0,0,0,6,0
0,0,0,0,0,0,0,0,0,0,0,0,0,0,0,0,0,0,0,0,0,0,0,0,0,1,0
0,0,0,0,0,0,0,0,0,0,11,0,0,0,0,0,0,0,0,0,0,7,0,0,0,0,0
0,0,0,0,0,0,0,0,0,0,0,0,0,0,0,0,0,0,0,0,0,0,0,0,0,0,0
0,0,0,0,0,0,0,0,0,0,0,0,0,0,0,0,0,0,0,0,0,0,0,0,0,1,0
0,0,0,0,0,0,0,0,0,0,22,0,0,0,0,0,0,0,0,0,0,0,0,0,0,0,0
0,0,0,0,0,0,0,0,0,0,0,0,0,0,0,0,0,0,0,0,0,0,0,0,0,0,0

#Vehicle Boundaries
0,0,0,0,0,0,0,0,0,0,0,0,0,0,0,0,0,0,0,0,0,0,0,0,0,0,0
0,0,0,0,0,0,0,0,0,0,0,0,0,0,0,0,0,0,0,0,0,0,0,0,0,0,0
0,0,0,0,0,0,0,0,0,0,0,0,0,0,0,0,0,0,0,0,0,0,0,0,0,0,0
0,0,0,0,0,0,0,0,0,0,0,0,0,0,0,0,0,0,0,0,0,0,0,0,0,0,0
0,0,0,0,0,0,0,0,0,0,0,0,0,0,0,0,0,0,0,0,0,0,0,0,0,0,0
0,0,0,0,0,0,0,0,0,0,0,0,0,0,0,0,0,0,0,0,0,0,0,0,0,0,0
0,0,0,0,0,0,0,0,0,0,0,0,0,0,0,0,0,0,0,0,0,0,0,0,0,0,0
0,0,0,0,0,0,0,0,0,0,0,0,0,0,0,0,0,0,0,0,0,0,0,0,0,0,0
0,0,0,0,0,0,0,0,0,0,0,0,0,0,0,0,0,0,0,0,0,0,0,0,0,0,0
0,0,0,0,0,0,0,0,0,0,0,0,0,0,0,0,0,0,0,0,0,0,0,0,0,0,0
0,0,0,0,0,0,0,0,0,0,0,0,0,0,0,0,0,0,0,0,0,0,0,0,0,0,0
0,0,0,0,0,0,0,0,0,0,0,0,0,0,0,0,0,0,0,0,0,0,0,0,0,0,0
0,0,0,0,0,0,0,0,0,0,0,0,0,0,0,0,0,0,0,0,0,0,0,0,0,0,0
0,0,0,0,0,0,0,0,0,0,0,0,0,0,0,0,0,0,0,0,0,0,0,0,0,0,0
0,0,0,0,0,0,0,0,0,0,0,0,0,0,0,0,0,0,0,0,0,0,0,0,0,0,0
0,0,0,0,0,0,0,0,0,0,0,0,0,0,0,0,0,0,0,0,0,0,0,0,0,0,0
0,0,0,0,0,0,0,0,0,0,0,0,0,0,0,0,0,0,0,0,0,0,0,0,0,0,0
0,0,0,0,0,0,0,0,0,0,0,0,0,0,0,0,0,0,0,0,0,0,0,0,0,0,0
0,0,0,0,0,0,0,0,0,0,0,0,0,0,0,0,0,0,0,0,0,0,0,0,0,0,0

#Stages
#Stage Type 0,Map,Mode,Goal,Points,Bonus List(Max 10),Name,End World, then mode settings (see sample tour file for details)
#Stage Type 1,Bonus House Name,Sequential/Random Order,Display Text,Powerup List
17
0,Smelting Pot,15,15,1,0,Smelting Pot,0,7,150,0,2,0,3,0,0,1,1,2,0,0,0,0,0,5,3,0,0,0,0
0,Store for this and that,11,250,1,0,Store for This and That,0,25,600,0,1,1
0,IndustialZone,1,10,1,0,Industrial Zone,0,0,0
0,CarCrusher,16,15,1,0,Car Crusher,0,10,0,0,25,5,0
0,Piston Panic,10,2,1,0,Piston Panic,0,30,0,0
0,Industrial Madness,8,200,1,0,Industrial Madness,0,1,1
0,Caution! Moving Parts,9,200,1,0,Caution! Moving Parts,0,1
0,McMishima-'s,3,12,1,0,McMishima's Gate,0,2,900,1,10
0,The Skin Factory,5,30,2,1w5,The Skin Factory,0,45,10,7,5,2,1,3,5,3,1
0,Warehouse,6,13,1,0,Warehouse,0,1,1,1,1,1,0,0,0,10
0,0factory,7,10,1,0,Moving Factory,0,3,1,1,0,0,0
0,Nameless Factory,12,135,1,0,Nameless Factory,0,6,1500,10
0,Friendly Factory,2,90,1,0,Friendly Factory,0,0,0,5
0,Delivery Line,0,15,3,0,Delivery Line,1,0
1,Toad's House,1,||Pick an item to help you on your way!||,p9,p11,p10
1,Toad's House,1,||Pick an item to help you on your way!||,p8,p16,p10
1,Spade House,1,||Take your chances and hope you win!||,p0,p1,p2,p3,p4

#Warps
#location 1 x, y, location 2 x, y
0

#Vehicles
#Sprite,Stage Type, Start Column, Start Row, Min Moves, Max Moves, Sprite Paces, Sprite Direction, Boundary
0

#Initial Items
w1,w4,w10,w1,p11,p11,p9,p10
