#Version
1.8.0.2

#Music Category
7

#Width
39

#Height
19

#Sprite Water Layer
6,6,6,6,6,6,6,6,6,6,6,6,6,6,6,6,6,6,6,6,6,6,6,6,6,6,6,6,6,6,6,6,6,6,6,6,6,6,6
6,6,6,6,6,6,6,6,6,6,6,6,6,6,6,6,6,6,6,6,6,6,6,6,6,6,6,6,6,6,6,6,6,6,6,6,6,6,6
6,6,6,6,6,6,6,6,6,6,6,6,6,6,6,6,6,6,6,6,6,6,6,6,6,6,6,6,6,6,6,6,6,6,6,6,6,6,6
6,6,6,6,6,6,6,6,6,6,6,6,6,6,6,6,6,6,6,6,6,6,6,6,6,6,6,6,6,6,6,6,6,6,6,6,6,6,6
6,6,6,6,6,6,6,6,6,6,6,6,6,6,6,6,6,6,6,6,6,6,6,6,6,6,6,6,6,6,6,6,6,6,6,6,6,6,6
6,6,6,6,6,6,6,6,6,6,6,6,6,6,6,6,6,6,6,6,6,6,6,6,6,6,6,6,6,6,6,6,6,6,6,6,6,6,6
6,6,6,6,6,6,6,6,6,6,6,6,6,6,6,6,6,6,6,6,6,6,6,6,6,6,6,6,6,6,6,6,6,6,6,6,6,6,6
6,6,6,6,6,6,6,6,6,6,6,6,6,6,6,6,6,6,6,6,6,6,6,6,6,6,6,6,6,6,6,6,6,6,6,6,6,6,6
6,6,6,6,6,6,6,6,6,6,6,6,6,6,6,6,6,6,6,6,6,6,6,6,6,6,6,6,6,6,6,6,6,6,6,6,6,6,6
6,6,6,6,6,6,6,6,6,6,6,6,6,6,6,6,6,6,6,6,6,6,6,6,6,6,6,6,6,6,6,6,6,6,6,6,6,6,6
6,6,6,6,6,6,6,6,6,6,6,6,6,6,6,6,6,6,6,6,6,6,6,6,6,6,6,6,6,6,6,6,6,6,6,6,6,6,6
6,6,6,6,6,6,6,6,6,6,6,6,6,6,6,6,6,6,6,6,6,6,6,6,6,6,6,6,6,6,6,6,6,6,6,6,6,6,6
6,6,6,6,6,6,6,6,6,6,6,6,6,6,6,6,6,6,6,6,6,6,6,6,6,6,6,6,6,6,6,6,6,6,6,6,6,6,6
6,6,6,6,6,6,6,6,6,6,6,6,6,6,6,6,6,6,6,6,6,6,6,6,6,6,6,6,6,6,6,6,6,6,6,6,0,4,4
6,6,6,6,6,6,6,6,6,6,6,6,6,6,6,6,6,6,6,6,6,6,6,6,6,6,6,6,6,6,6,6,6,6,6,6,4,4,4
6,6,6,6,6,6,6,6,6,6,6,6,6,6,6,6,6,6,6,6,6,6,6,6,6,6,6,6,6,6,6,6,6,6,4,4,4,4,4
6,6,6,6,6,6,6,6,6,6,6,6,6,6,6,6,6,6,6,6,6,6,6,6,6,6,6,6,6,6,6,6,6,6,4,4,4,4,4
6,6,6,6,6,6,6,6,6,6,6,6,6,6,6,6,6,6,6,6,6,6,6,6,6,6,6,6,6,6,6,6,6,4,4,4,4,4,4
6,6,6,6,6,6,6,6,6,6,6,6,6,6,6,6,6,6,6,6,6,6,6,6,6,6,6,6,6,6,6,6,6,4,4,4,4,4,4

#Sprite Background Layer
0,0,0,0,0,0,0,0,0,0,0,0,0,0,0,0,0,0,0,0,0,0,375,361,361,361,361,361,361,361,361,361,361,361,361,374,0,15,1
0,0,0,0,0,365,373,373,373,364,0,365,373,373,373,373,373,373,364,0,0,0,362,372,384,361,361,361,361,361,361,361,361,361,361,374,5,25,1
0,0,0,0,0,375,361,361,361,386,373,385,361,361,361,361,361,361,386,364,0,0,0,0,362,384,361,361,361,361,361,361,361,361,387,363,15,1,1
0,0,0,0,365,385,361,361,361,361,361,361,361,361,361,361,361,361,361,386,364,0,0,0,0,362,372,384,361,361,361,361,361,361,374,0,15,1,1
0,0,0,365,385,361,361,361,361,361,361,361,361,361,361,361,361,361,361,361,386,364,0,0,0,0,0,362,384,361,361,361,361,361,374,5,25,1,1
0,0,365,385,361,361,361,361,361,361,361,361,361,361,361,361,361,361,361,361,361,386,373,364,0,0,0,0,375,361,361,361,361,387,363,15,1,1,1
0,0,375,361,361,361,361,361,361,361,361,361,361,361,361,361,361,361,361,361,361,361,361,386,364,0,0,0,362,372,372,372,372,363,0,15,1,1,1
0,0,375,361,361,361,361,361,361,361,361,361,361,361,361,361,361,361,361,361,361,361,361,361,374,0,0,0,0,0,0,0,0,0,5,25,1,1,1
0,0,375,361,361,361,361,361,361,361,361,361,361,361,361,361,361,361,361,361,361,361,361,361,386,364,0,0,0,0,0,0,0,5,25,1,1,1,1
0,0,375,361,361,361,361,361,361,361,361,361,361,361,361,361,361,361,361,361,361,361,361,361,361,374,0,0,0,0,0,0,0,15,1,1,1,1,1
0,0,375,361,361,361,361,361,361,361,361,361,361,361,361,361,361,361,361,361,361,361,361,361,361,386,364,0,0,0,0,0,5,25,1,1,1,1,1
0,0,362,384,361,361,361,361,361,361,361,361,361,361,361,361,361,361,361,361,361,361,361,361,361,361,374,0,0,0,0,5,25,1,1,27,24,1,1
0,0,0,362,384,361,361,361,387,384,361,361,361,361,361,361,361,361,361,361,361,361,361,361,361,361,386,364,0,0,0,15,1,1,1,26,25,1,1
0,0,0,0,362,372,372,372,363,362,372,384,361,361,361,361,361,361,361,361,361,361,361,361,361,361,361,374,0,0,5,25,1,1,1,1,1,1,27
0,0,0,0,0,0,0,0,0,0,0,362,372,372,384,361,361,361,361,361,361,361,361,361,361,361,361,386,364,5,25,1,1,1,1,1,27,12,3
0,0,0,0,0,0,0,0,0,0,0,0,0,0,362,372,384,361,361,361,361,361,361,361,361,361,361,361,374,15,1,1,1,1,27,12,3,0,0
0,0,0,0,0,0,0,0,0,0,0,0,0,0,0,0,375,361,361,361,361,361,361,361,361,361,361,361,374,15,1,1,1,1,14,0,0,0,0
0,0,0,0,0,0,0,0,0,0,0,0,0,0,0,0,362,384,361,361,361,361,361,361,361,361,361,361,374,15,1,1,1,27,3,0,0,0,0
0,0,0,0,0,0,0,0,0,0,0,0,0,0,0,0,0,362,384,361,361,361,361,361,361,361,361,361,374,15,1,1,1,14,0,0,0,0,0

#Sprite Foreground Layer
0,0,0,0,0,0,0,0,0,0,0,0,0,0,0,0,0,0,0,0,0,0,0,0,801,0,907,906,907,908,904,905,909,908,902,0,0,0,0
0,0,0,0,0,0,0,0,0,0,0,0,0,0,0,0,0,0,0,0,0,0,0,0,0,0,801,907,908,906,908,909,906,905,909,0,0,0,0
0,0,0,0,0,0,788,856,788,0,0,0,913,913,913,913,913,913,0,0,0,0,0,0,0,0,0,784,907,904,749,904,907,909,0,0,0,0,910
0,0,0,0,0,0,800,2,788,812,800,0,0,801,0,0,808,0,913,0,0,0,0,0,0,0,0,0,784,909,761,1,1,917,13,17,15,724,3
0,0,0,0,0,788,812,2,0,801,0,812,6,1,1,861,0,0,0,913,0,0,0,0,0,0,0,0,0,801,907,907,909,906,0,0,0,0,2
0,0,0,0,788,801,0,2,0,802,0,0,2,0,0,0,802,808,0,0,913,0,0,0,0,0,0,0,0,0,808,0,808,0,0,0,0,0,403
0,0,0,788,812,801,0,2,808,0,6,1,705,1,1,1,3,0,0,801,0,862,913,0,0,0,0,0,0,0,0,0,0,0,0,0,910,0,2
0,0,0,800,801,0,812,2,0,801,2,802,0,0,0,0,2,0,913,0,0,2,0,913,0,0,0,0,0,0,0,0,0,0,0,0,0,707,2
0,0,0,788,608,1,1,5,0,0,2,0,801,0,808,0,2,0,802,808,0,2,0,913,0,0,0,0,0,0,0,0,0,0,0,0,0,719,5
0,0,0,800,0,0,802,2,0,808,2,0,0,801,0,0,401,1,1,703,1,5,0,0,913,0,0,0,0,0,0,0,0,0,732,910,0,2,0
0,0,0,788,812,801,0,400,1,1,5,0,802,0,808,802,2,915,913,915,913,2,0,0,913,0,0,0,0,0,0,0,0,0,744,1,1,5,822
0,0,0,0,788,800,801,0,0,0,0,801,0,0,0,0,2,913,915,913,915,2,0,0,0,913,0,0,0,0,0,0,0,0,2,0,0,2,0
0,0,0,0,0,788,913,808,0,0,913,0,0,860,1,1,5,1,702,1,1,5,0,0,0,913,0,0,0,0,0,0,0,0,2,0,0,739,799
0,0,0,0,0,0,0,0,0,0,0,0,913,0,0,0,0,0,0,0,0,2,0,802,0,0,913,0,0,0,0,0,0,910,2,718,911,2,0
0,0,0,0,0,0,0,0,0,0,0,0,0,0,0,913,801,0,802,0,0,2,0,0,0,0,913,0,0,0,0,0,822,0,4,402,13,9,789
0,0,0,0,0,0,0,0,0,0,0,0,0,0,0,0,0,0,0,0,708,709,0,0,802,0,0,913,0,0,0,916,0,0,0,14,0,0,0
0,0,0,0,0,0,0,0,0,0,0,0,0,0,0,0,0,915,0,0,720,721,1,1,1,712,1,1,779,779,1,751,1,1,13,700,0,0,789
0,0,0,0,0,0,0,0,0,0,0,0,0,0,0,0,0,0,915,0,0,0,0,0,0,0,0,913,0,0,0,916,0,0,0,0,0,0,0
0,0,0,0,0,0,0,0,0,0,0,0,0,0,0,0,0,0,0,915,0,821,0,821,0,821,0,913,0,0,910,0,910,0,0,0,789,0,0

#Connections
0,0,0,0,0,0,0,0,0,0,0,0,0,0,0,0,0,0,0,0,0,0,0,0,0,0,0,0,0,0,0,0,0,0,0,0,0,0,0
0,0,0,0,0,0,0,0,0,0,0,0,0,0,0,0,0,0,0,0,0,0,0,0,0,0,0,0,0,0,0,0,0,0,0,0,0,0,0
0,0,0,0,0,0,0,1,0,0,0,0,0,0,0,0,0,0,0,0,0,0,0,0,0,0,0,0,0,0,0,0,0,0,0,0,0,0,0
0,0,0,0,0,0,0,1,0,0,0,0,0,0,0,0,0,0,0,0,0,0,0,0,0,0,0,0,0,0,2,2,2,2,2,2,2,2,6
0,0,0,0,0,0,0,1,0,0,0,0,5,2,2,2,0,0,0,0,0,0,0,0,0,0,0,0,0,0,0,0,0,0,0,0,0,0,1
0,0,0,0,0,0,0,1,0,0,0,0,1,0,0,0,0,0,0,0,0,0,0,0,0,0,0,0,0,0,0,0,0,0,0,0,0,0,1
0,0,0,0,0,0,0,1,0,0,5,2,8,2,2,2,6,0,0,0,0,1,0,0,0,0,0,0,0,0,0,0,0,0,0,0,0,0,1
0,0,0,0,0,0,0,1,0,0,1,0,0,0,0,0,1,0,0,0,0,1,0,0,0,0,0,0,0,0,0,0,0,0,0,0,0,0,1
0,0,0,0,2,2,2,7,0,0,1,0,0,0,0,0,1,0,0,0,0,1,0,0,0,0,0,0,0,0,0,0,0,0,0,0,0,5,3
0,0,0,0,0,0,0,1,0,0,1,0,0,0,0,0,9,2,2,2,2,7,0,0,0,0,0,0,0,0,0,0,0,0,0,0,0,1,0
0,0,0,0,0,0,0,4,2,2,3,0,0,0,0,0,1,0,0,0,0,1,0,0,0,0,0,0,0,0,0,0,0,0,5,2,2,7,0
0,0,0,0,0,0,0,0,0,0,0,0,0,0,0,0,1,0,0,0,0,1,0,0,0,0,0,0,0,0,0,0,0,0,1,0,0,1,0
0,0,0,0,0,0,0,0,0,0,0,0,0,2,2,2,8,2,2,2,2,7,0,0,0,0,0,0,0,0,0,0,0,0,1,0,0,1,0
0,0,0,0,0,0,0,0,0,0,0,0,0,0,0,0,0,0,0,0,0,1,0,0,0,0,0,0,0,0,0,0,0,0,1,0,0,1,0
0,0,0,0,0,0,0,0,0,0,0,0,0,0,0,0,0,0,0,0,0,1,0,0,0,0,0,0,0,0,0,0,0,0,4,10,2,3,0
0,0,0,0,0,0,0,0,0,0,0,0,0,0,0,0,0,0,0,0,0,1,0,0,0,0,0,0,0,0,0,0,0,0,0,1,0,0,0
0,0,0,0,0,0,0,0,0,0,0,0,0,0,0,0,0,0,0,0,0,4,2,2,2,2,2,2,2,2,2,2,2,2,2,3,0,0,0
0,0,0,0,0,0,0,0,0,0,0,0,0,0,0,0,0,0,0,0,0,0,0,0,0,0,0,0,0,0,0,0,0,0,0,0,0,0,0
0,0,0,0,0,0,0,0,0,0,0,0,0,0,0,0,0,0,0,0,0,0,0,0,0,0,0,0,0,0,0,0,0,0,0,0,0,0,0

#Tile Types
0,0,0,0,0,0,0,0,0,0,0,0,0,0,0,0,0,0,0,0,0,0,0,0,0,0,0,0,0,0,0,0,0,0,0,0,0,0,0
0,0,0,0,0,0,0,0,0,0,0,0,0,0,0,0,0,0,0,0,0,0,0,0,0,0,0,0,0,0,0,0,0,0,0,0,0,0,0
0,0,0,0,0,0,0,25,0,0,0,0,0,0,0,0,0,0,0,0,0,0,0,0,0,0,0,0,0,0,0,0,0,0,0,0,0,0,0
0,0,0,0,0,0,0,0,0,0,0,0,0,0,0,0,0,0,0,0,0,0,0,0,0,0,0,0,0,0,24,0,0,23,0,0,0,22,0
0,0,0,0,0,0,0,0,0,0,0,0,0,0,0,27,0,0,0,0,0,0,0,0,0,0,0,0,0,0,0,0,0,0,0,0,0,0,0
0,0,0,0,0,0,0,0,0,0,0,0,0,0,0,0,0,0,0,0,0,0,0,0,0,0,0,0,0,0,0,0,0,0,0,0,0,0,21
0,0,0,0,0,0,0,2,0,0,0,0,7,0,0,0,0,0,0,0,0,28,0,0,0,0,0,0,0,0,0,0,0,0,0,0,0,0,0
0,0,0,0,0,0,0,0,0,0,0,0,0,0,0,0,0,0,0,0,0,0,0,0,0,0,0,0,0,0,0,0,0,0,0,0,0,0,0
0,0,0,0,1,0,0,0,0,0,0,0,0,0,0,0,0,0,0,0,0,3,0,0,0,0,0,0,0,0,0,0,0,0,0,0,0,20,0
0,0,0,0,0,0,0,0,0,0,0,0,0,0,0,0,8,0,0,9,0,0,0,0,0,0,0,0,0,0,0,0,0,0,0,0,0,0,0
0,0,0,0,0,0,0,6,0,0,0,0,0,0,0,0,0,0,0,0,0,0,0,0,0,0,0,0,0,0,0,0,0,0,17,0,0,0,0
0,0,0,0,0,0,0,0,0,0,0,0,0,0,0,0,0,0,0,0,0,0,0,0,0,0,0,0,0,0,0,0,0,0,0,0,0,0,0
0,0,0,0,0,0,0,0,0,0,0,0,0,26,0,3,0,0,10,0,0,0,0,0,0,0,0,0,0,0,0,0,0,0,0,0,0,19,0
0,0,0,0,0,0,0,0,0,0,0,0,0,0,0,0,0,0,0,0,0,0,0,0,0,0,0,0,0,0,0,0,0,0,0,0,0,0,0
0,0,0,0,0,0,0,0,0,0,0,0,0,0,0,0,0,0,0,0,0,0,0,0,0,0,0,0,0,0,0,0,0,0,0,16,0,0,0
0,0,0,0,0,0,0,0,0,0,0,0,0,0,0,0,0,0,0,0,0,0,0,0,0,0,0,0,0,0,0,0,0,0,0,0,0,0,0
0,0,0,0,0,0,0,0,0,0,0,0,0,0,0,0,0,0,0,0,0,12,0,0,0,13,0,0,0,0,0,14,0,0,0,15,0,0,0
0,0,0,0,0,0,0,0,0,0,0,0,0,0,0,0,0,0,0,0,0,0,0,0,0,0,0,0,0,0,0,0,0,0,0,0,0,0,0
0,0,0,0,0,0,0,0,0,0,0,0,0,0,0,0,0,0,0,0,0,0,0,0,0,0,0,0,0,0,0,0,0,0,0,0,0,0,0

#Vehicle Boundaries
0,0,0,0,0,0,0,0,0,0,0,0,0,0,0,0,0,0,0,0,0,0,0,0,0,0,0,0,0,0,0,0,0,0,0,0,0,0,0
0,0,0,0,0,0,0,0,0,0,0,0,0,0,0,0,0,0,0,0,0,0,0,0,0,0,0,0,0,0,0,0,0,0,0,0,0,0,0
0,0,0,0,0,0,0,0,0,0,0,0,0,0,0,0,0,0,0,0,0,0,0,0,0,0,0,0,0,0,0,0,0,0,0,0,0,0,0
0,0,0,0,0,0,0,0,0,0,0,0,0,0,0,0,0,0,0,0,0,0,0,0,0,0,0,0,0,0,0,0,0,0,0,0,0,0,0
0,0,0,0,0,0,0,0,0,0,0,0,0,0,0,0,0,0,0,0,0,0,0,0,0,0,0,0,0,0,0,0,0,0,0,0,0,0,0
0,0,0,0,0,0,0,0,0,0,0,0,0,0,0,0,0,0,0,0,0,0,0,0,0,0,0,0,0,0,0,0,0,0,0,0,0,0,0
0,0,0,0,0,0,0,0,0,0,0,0,0,0,0,0,1,0,0,0,0,0,0,0,0,0,0,0,0,0,0,0,0,0,0,0,0,0,0
0,0,0,0,0,0,0,0,0,0,0,0,0,0,0,0,0,0,0,0,0,0,0,0,0,0,0,0,0,0,0,0,0,0,0,0,0,0,0
0,0,0,0,0,0,0,0,0,0,0,0,0,0,0,0,0,0,0,0,0,1,0,0,0,0,0,0,0,0,0,0,0,0,0,0,0,0,0
0,0,0,0,0,0,0,0,0,0,0,0,0,0,0,0,0,0,0,0,0,0,0,0,0,0,0,0,0,0,0,0,0,0,0,0,0,2,0
0,0,0,0,0,0,0,0,0,0,0,0,0,0,0,0,0,0,0,0,0,0,0,0,0,0,0,0,0,0,0,0,0,0,0,0,0,0,0
0,0,0,0,0,0,0,0,0,0,0,0,0,0,0,0,0,0,0,0,0,0,0,0,0,0,0,0,0,0,0,0,0,0,0,0,0,0,0
0,0,0,0,0,0,0,0,0,0,0,0,0,0,0,1,0,0,0,0,0,0,0,0,0,0,0,0,0,0,0,0,0,0,0,0,0,0,0
0,0,0,0,0,0,0,0,0,0,0,0,0,0,0,0,0,0,0,0,0,0,0,0,0,0,0,0,0,0,0,0,0,0,0,0,0,0,0
0,0,0,0,0,0,0,0,0,0,0,0,0,0,0,0,0,0,0,0,0,1,0,0,0,0,0,0,0,0,0,0,0,0,0,0,0,0,0
0,0,0,0,0,0,0,0,0,0,0,0,0,0,0,0,0,0,0,0,0,0,0,0,0,0,0,0,0,0,0,0,0,0,0,2,0,0,0
0,0,0,0,0,0,0,0,0,0,0,0,0,0,0,0,0,0,0,0,0,0,0,0,0,0,0,0,0,0,0,0,0,0,0,0,0,0,0
0,0,0,0,0,0,0,0,0,0,0,0,0,0,0,0,0,0,0,0,0,0,0,0,0,0,0,0,0,0,0,0,0,0,0,0,0,0,0
0,0,0,0,0,0,0,0,0,0,0,0,0,0,0,0,0,0,0,0,0,0,0,0,0,0,0,0,0,0,0,0,0,0,0,0,0,0,0

#Stages
#Stage Type 0,Map,Mode,Goal,Points,Bonus List(Max 10),Name,End World, then mode settings (see sample tour file for details)
#Stage Type 1,Bonus House Name,Sequential/Random Order,Display Text,Powerup List
23
0,DXMcastle,16,10,1,0,DX Castle,0,0,3,1,30,3,1
0,Dark Castle,10,10,2,1w5,Dark Castle,0,7,1,0
0,Castle o Awesome,0,10,1,0,Castle Of Awesome,0,0
0,Hazardous Castle,9,250,2,1w4|1p6,Hazardous Castle,0,1
0,Nights Castle,4,50,2,1w4|1p8,Night's Castle,0,1,5
0,End of the Line,5,50,1,0,End of the Line,0,15,10,5,3,1,1,1,5,2,1
0,Castle 72,1,25,3,1w6|2w1|1w12|3p13,Castle 72,0,0,0
0,Alecs castle inverted,0,15,1,4p0,Alecs Inverted Castle,0,0
0,Only One Will Stand Tall,12,150,2,1w4|2p18,Onle One Will Stand Tall,0,5,960,5
0,UnderwaterCastle,8,200,2,1p17,Underwater Castle,0,1,1
0,Castle!,15,25,1,0,Castle Gates,0,4,30,0,3,9,6,7,8,2,2,1,9,5,1,2,1,3,3,5,7,6,5
0,Vivid Castle,13,15,2,1w4,Vivid Castle,0,5,8,0
0,Pot Luck Castle,5,10,1,0,Pot Luck Castle,0,300,0,5,0,1,0,0,1,0,0
0,Icy Fire Castle,7,15,2,1w4,Freezeflame Castle,0,6,1,1,0,0,1
0,Unnamed Castle Map,2,70,3,1p8|2p5,A Doll's Secretive Castle,0,0,0,5
0,Chain Link Chamber,14,150,1,0,Chain Link Chamber,0
0,Castle of Chaos,11,250,2,1w6,Castle of Chaos,0,26,1500,1,0,0
0,Another storm to remote control,6,26,1,0,Storming Remote Control,0,4,0,0,0,1,0,0,0,15
0,Another jungle castle,1,30,5,0,Jungle Castle,1,0,0
1,Toad's House,1,||Pick an item to help you on your way!||,p9,p10,p11
1,Toad's House,1,||Pick an item to help you on your way!||,p9,p10,p19
1,Poison House,1,||Choose an item if you dare!||,p0,p0,w1
1,Poison House,1,||Choose an item if you dare!||,p0,p0,w14

#Warps
#location 1 x, y, location 2 x, y
0

#Vehicles
#Sprite,Stage Type, Start Column, Start Row, Min Moves, Max Moves, Sprite Paces, Sprite Direction, Boundary
2
3,12,34,12,5,8,1,0,2
2,5,19,12,5,8,1,0,1

#Initial Items
w2,w4,w4,w9,w10,w11,w13
