#Version
1.8.0.2

#Music Category
2

#Width
20

#Height
15

#Sprite Water Layer
0,0,0,0,0,0,0,0,0,0,0,0,0,0,0,0,0,0,0,0
0,0,0,0,0,0,0,0,0,0,0,0,0,0,0,0,0,0,0,0
0,0,0,0,0,0,0,0,0,0,0,0,0,0,0,0,0,0,0,0
0,0,0,0,0,0,0,0,0,0,0,0,0,0,0,0,0,0,0,0
0,0,0,0,0,0,0,0,0,0,0,0,0,0,0,0,0,0,0,0
0,0,0,0,0,0,0,0,0,0,0,0,0,0,0,0,0,0,0,0
0,0,0,0,0,0,0,0,0,0,0,0,0,0,0,0,0,0,0,0
0,0,0,0,0,0,0,0,0,0,0,0,0,0,0,0,0,0,0,0
0,0,0,0,0,0,0,0,0,0,0,0,0,0,0,0,0,0,0,0
0,0,0,0,0,0,0,0,0,0,0,0,0,0,0,0,0,0,0,0
0,0,0,0,0,0,0,0,0,0,0,0,0,0,0,0,0,0,0,0
0,0,0,0,0,0,0,0,0,0,0,0,0,0,0,0,0,0,0,0
0,0,0,0,0,0,0,0,0,0,0,0,0,0,0,0,0,0,0,0
0,0,0,0,0,0,0,0,0,0,0,0,0,0,0,0,0,0,0,0
0,0,0,0,0,0,0,0,0,0,0,0,0,0,0,0,0,0,0,0

#Sprite Background Layer
61,61,74,0,0,0,0,0,0,0,0,0,0,0,0,0,0,65,73,64
61,61,74,0,0,0,0,0,0,0,0,0,0,0,0,0,0,75,61,74
61,87,63,0,0,0,0,0,0,0,0,0,0,0,0,0,0,62,72,63
72,63,0,0,0,0,0,0,0,0,0,0,0,0,0,0,0,0,0,0
0,0,0,0,0,0,0,0,0,0,0,0,0,0,0,0,0,0,0,0
73,73,73,64,0,0,0,0,0,0,0,0,0,0,0,0,0,0,0,0
61,61,61,86,64,0,0,0,0,0,0,0,0,0,0,0,0,65,73,64
61,61,61,61,74,0,0,0,0,0,0,0,0,0,0,0,0,75,61,74
61,61,61,87,63,0,0,0,0,0,0,0,0,0,0,0,0,62,72,63
84,61,87,63,0,0,0,0,0,0,0,0,0,0,0,0,0,0,0,0
81,103,68,0,0,0,0,0,0,0,0,0,0,0,0,0,0,0,0,0
61,61,86,64,0,0,0,0,0,0,0,0,0,0,0,0,0,65,73,64
61,61,61,86,64,0,0,0,0,0,0,0,0,0,0,0,0,75,61,74
61,61,61,61,74,0,0,0,0,0,0,0,0,0,0,0,0,62,72,63
61,61,61,87,63,0,0,0,0,0,0,0,0,0,0,0,0,0,0,0

#Sprite Foreground Layer
901,845,0,0,789,0,0,0,0,789,0,0,0,0,0,0,0,0,0,0
0,102,0,0,0,0,0,789,0,0,110,117,107,117,117,117,117,115,846,0
904,114,0,749,0,0,0,0,0,0,118,790,118,0,0,0,0,0,0,0
0,108,117,761,0,0,0,0,110,117,109,117,109,0,0,0,790,0,0,0
0,789,0,0,0,789,0,790,118,0,118,0,118,0,790,0,0,0,0,0
0,0,0,0,0,0,110,117,109,117,109,117,109,0,0,0,0,0,0,0
0,904,0,0,0,0,118,0,118,790,118,0,118,0,0,734,735,0,0,0
609,101,300,101,113,117,109,117,109,117,109,117,109,117,117,117,301,115,845,0
904,0,901,0,0,0,118,0,118,0,118,0,118,0,0,0,0,0,0,0
0,856,0,0,789,0,108,117,109,117,109,117,109,0,0,0,0,790,0,0
0,773,0,0,0,0,0,0,118,790,118,0,118,0,746,747,0,0,0,0
851,105,0,0,789,0,0,0,108,117,109,117,109,0,0,0,0,0,0,0
901,0,904,0,0,0,0,0,0,0,118,0,118,0,790,0,0,0,851,0
901,846,101,859,0,0,789,0,0,0,108,117,109,117,117,117,117,117,109,0
0,901,904,0,0,0,0,0,0,0,0,0,0,0,0,0,0,0,0,0

#Connections
0,1,0,0,0,0,0,0,0,0,0,0,0,0,0,0,0,0,0,0
0,1,0,0,0,0,0,0,0,0,5,2,10,2,2,2,2,2,2,0
0,1,0,0,0,0,0,0,0,0,1,0,1,0,0,0,0,0,0,0
0,4,2,2,0,0,0,0,5,2,11,2,7,0,0,0,0,0,0,0
0,0,0,0,0,0,0,0,1,0,1,0,1,0,0,0,0,0,0,0
0,0,0,0,0,0,5,2,11,2,11,2,7,0,0,0,0,0,0,0
0,0,0,0,0,0,1,0,1,0,1,0,1,0,0,0,0,0,0,0
2,2,2,2,2,2,11,2,11,2,11,2,11,2,2,2,2,2,2,0
0,0,0,0,0,0,1,0,1,0,1,0,1,0,0,0,0,0,0,0
0,1,0,0,0,0,4,2,11,2,11,2,7,0,0,0,0,0,0,0
0,1,0,0,0,0,0,0,1,0,1,0,1,0,0,0,0,0,0,0
2,3,0,0,0,0,0,0,4,2,11,2,7,0,0,0,0,0,0,0
0,0,0,0,0,0,0,0,0,0,1,0,1,0,0,0,0,0,1,0
0,2,2,2,0,0,0,0,0,0,4,2,8,2,2,2,2,2,3,0
0,0,0,0,0,0,0,0,0,0,0,0,0,0,0,0,0,0,0,0

#Tile Types
0,0,0,0,0,0,0,0,0,0,0,0,0,0,0,0,0,0,0,0
0,0,0,0,0,0,0,0,0,0,0,0,0,0,4,0,0,0,0,0
0,0,0,0,0,0,0,0,0,0,0,0,0,0,0,0,0,0,0,0
0,0,0,12,0,0,0,0,0,0,0,0,0,0,0,0,0,0,0,0
0,0,0,0,0,0,0,0,0,0,0,0,0,0,0,0,0,0,0,0
0,0,0,0,0,0,0,0,0,0,0,0,0,0,0,0,0,0,0,0
0,0,0,0,0,0,0,0,0,0,0,0,0,0,0,0,0,0,0,0
1,0,6,0,0,0,0,0,0,0,0,0,0,0,5,0,11,0,0,0
0,0,0,0,0,0,0,0,0,0,0,0,0,0,0,0,0,0,0,0
0,14,0,0,0,0,0,0,0,0,0,0,0,0,0,0,0,0,0,0
0,0,0,0,0,0,0,0,0,0,0,0,0,0,0,0,0,0,0,0
0,0,0,0,0,0,0,0,0,0,0,0,0,0,0,0,0,0,0,0
0,0,0,0,0,0,0,0,0,0,0,0,0,0,0,0,0,0,0,0
0,0,0,13,0,0,0,0,0,0,0,0,0,0,2,0,0,0,0,0
0,0,0,0,0,0,0,0,0,0,0,0,0,0,0,0,0,0,0,0

#Vehicle Boundaries
0,0,0,0,0,0,0,0,0,0,0,0,0,0,0,0,0,0,0,0
0,0,0,0,0,0,0,0,0,0,0,0,0,1,0,0,0,0,0,0
0,0,0,0,0,0,0,0,0,0,0,0,0,0,0,0,0,0,0,0
0,0,0,0,0,0,0,0,0,0,0,0,0,0,0,0,0,0,0,0
0,0,0,0,0,0,0,0,0,0,0,0,0,0,0,0,0,0,0,0
0,0,0,0,0,0,0,0,0,0,0,0,0,0,0,0,0,0,0,0
0,0,0,0,0,0,0,0,0,0,0,0,0,0,0,0,0,0,0,0
0,0,0,0,0,1,0,0,0,0,0,0,0,1,0,0,0,0,0,0
0,0,0,0,0,0,0,0,0,0,0,0,0,0,0,0,0,0,0,0
0,0,0,0,0,0,0,0,0,0,0,0,0,0,0,0,0,0,0,0
0,0,0,0,0,0,0,0,0,0,0,0,0,0,0,0,0,0,0,0
0,0,0,0,0,0,0,0,0,0,0,0,0,0,0,0,0,0,0,0
0,0,0,0,0,0,0,0,0,0,0,0,0,0,0,0,0,0,0,0
0,0,0,0,0,0,0,0,0,0,0,0,0,1,0,0,0,0,0,0
0,0,0,0,0,0,0,0,0,0,0,0,0,0,0,0,0,0,0,0

#Stages
#Stage Type 0,Map,Mode,Goal,Points,Bonus List(Max 10),Name,End World, then mode settings (see sample tour file for details)
#Stage Type 1,Bonus House Name,Sequential/Random Order,Display Text,Powerup List
9
0,PiratesCookie,2,60,1,0,Pirate's Cookie,0,0,0,10
0,Pirates of the Mushroom Kingdom,1,12,1,0,Pirates of the Mushroom Kingdom,0,0,0
0,Shipboard_,11,200,1,1w5,Shipboard,0,10,0,1,1,1
0,Pirates,0,10,1,1w8,Pirates,0,0
0,Wharf_Rats,10,5,2,1w7,Wharf Rats,0,25,1,0
0,Ghostship,16,20,1,0,Ghost Ship,0,3,2,1,35,1,1
0,Pirate battle,4,300,3,0,Pirate Battle,1,1,25
1,Toad's House,1,||Pick an item to help you on your way!||,p10,p15,p17
1,Toad's House,1,||Pick an item to help you on your way!||,w0,w14,p4

#Warps
#location 1 x, y, location 2 x, y
3
18,1,1,13
18,7,1,0
18,12,0,11

#Vehicles
#Sprite,Stage Type, Start Column, Start Row, Min Moves, Max Moves, Sprite Paces, Sprite Direction, Boundary
4
4,1,8,7,8,12,1,0,0
4,4,12,7,8,12,1,0,0
5,3,12,3,8,12,1,0,0
5,2,12,11,8,12,1,0,0

#Initial Items
w0,w2,w3,w3,w9,w12,w13,p10,p17
