#Version
1.8.0.0

#Music Category
0

#Width
18

#Height
12

#Sprite Water Layer
0,0,0,0,0,0,0,0,0,0,0,0,0,0,0,0,0,0
0,0,0,0,0,0,0,0,0,0,0,0,0,0,0,0,0,0
0,0,0,0,0,0,0,0,0,0,0,0,0,0,0,0,0,0
0,0,0,0,0,0,0,0,0,0,0,0,0,0,0,0,0,0
0,0,0,0,0,0,0,0,0,0,0,0,0,0,0,0,0,0
0,0,0,0,0,0,0,0,0,0,0,0,0,0,0,0,0,0
0,0,0,0,0,0,0,0,0,0,0,0,0,0,0,0,0,0
0,0,0,0,0,0,0,0,0,0,0,0,0,0,0,0,0,0
0,0,0,0,0,0,0,0,0,0,0,0,0,0,0,0,0,0
0,0,0,0,0,0,0,0,0,0,0,0,0,0,0,0,0,0
0,0,0,0,0,0,0,0,0,0,0,0,0,0,0,0,0,0
0,0,0,0,0,0,0,0,0,0,0,0,0,0,0,0,0,0

#Sprite Backgroud Layer
61,61,61,61,61,61,61,61,61,61,61,61,61,78,73,77,61,74
61,61,87,84,61,61,61,61,61,61,61,61,61,102,61,102,61,74
61,87,63,62,84,61,61,61,61,61,61,61,61,94,103,95,61,74
61,74,89,0,69,103,103,103,83,72,84,61,61,61,61,61,87,63
61,86,73,67,85,61,61,61,74,65,85,61,61,61,61,61,74,0
61,61,61,102,61,61,61,61,74,75,61,61,61,61,61,87,63,0
61,61,61,102,61,61,61,61,74,75,61,61,61,61,61,86,64,0
61,61,61,102,61,61,61,61,74,75,61,61,61,100,61,61,86,64
61,61,61,102,61,61,87,72,63,75,61,61,61,102,61,61,61,74
61,61,61,79,72,72,63,0,0,62,72,72,72,76,61,61,61,74
61,87,72,63,0,0,0,0,0,0,0,0,0,62,72,72,72,63
72,63,0,0,0,0,0,0,0,0,0,0,0,0,0,0,0,0

#Sprite Foregroud Layer
901,901,901,901,0,901,0,901,901,901,901,784,784,0,0,0,784,0
901,901,0,0,609,1,300,1,1,1,1,301,1,11,771,0,784,0
901,0,0,0,0,784,2,901,901,901,901,2,0,0,0,0,0,0
901,0,0,0,0,0,607,0,0,0,0,2,784,0,0,784,0,0
901,0,0,0,0,902,2,902,0,0,0,4,1,1,856,0,0,0
909,901,901,0,902,903,2,903,0,0,784,2,0,784,0,0,0,801
909,6,1,774,1,1,302,1,13,15,1,303,784,0,784,0,0,0
0,2,909,0,902,903,902,903,0,0,784,2,784,0,796,707,0,0
909,923,0,0,903,902,0,0,0,0,0,304,1,772,1,719,796,0
0,909,909,0,0,0,0,0,801,0,0,0,0,0,796,0,796,0
909,0,0,0,801,0,0,0,0,0,0,0,0,0,0,0,0,0
0,0,0,0,0,0,0,0,0,0,0,0,0,801,0,0,0,0

#Connections
0,0,0,0,0,0,0,0,0,0,0,0,0,0,0,0,0,0
0,0,0,0,2,2,10,2,2,2,2,10,2,2,2,0,0,0
0,0,0,0,0,0,1,0,0,0,0,1,0,0,0,0,0,0
0,0,0,0,0,0,15,0,0,0,0,1,0,0,0,0,0,0
0,0,0,0,0,0,1,0,0,0,0,9,2,2,2,0,0,0
0,0,0,0,0,0,1,0,0,0,0,1,0,0,0,0,0,0
0,5,2,2,2,2,8,2,2,2,2,7,0,0,0,0,0,0
0,1,0,0,0,0,0,0,0,0,0,1,0,0,0,0,0,0
0,1,0,0,0,0,0,0,0,0,0,4,2,2,2,2,0,0
0,0,0,0,0,0,0,0,0,0,0,0,0,0,0,0,0,0
0,0,0,0,0,0,0,0,0,0,0,0,0,0,0,0,0,0
0,0,0,0,0,0,0,0,0,0,0,0,0,0,0,0,0,0

#Tile Types
0,0,0,0,0,0,0,0,0,0,0,0,0,0,0,0,0,0
0,0,0,0,1,0,6,0,0,0,0,7,0,0,11,0,0,0
0,0,0,0,0,0,0,0,0,0,0,0,0,0,0,0,0,0
0,0,0,0,0,0,0,0,0,0,0,0,0,0,0,0,0,0
0,0,0,0,0,0,0,0,0,0,0,0,3,0,14,0,0,0
0,0,0,0,0,0,0,0,0,0,0,0,0,0,0,0,0,0
0,0,0,0,0,0,8,0,0,0,0,9,0,0,0,0,0,0
0,0,0,0,0,0,0,0,0,0,0,0,0,0,0,0,0,0
0,15,0,0,0,0,0,0,0,0,0,10,0,0,0,12,0,0
0,0,0,0,0,0,0,0,0,0,0,0,0,0,0,0,0,0
0,0,0,0,0,0,0,0,0,0,0,0,0,0,0,0,0,0
0,0,0,0,0,0,0,0,0,0,0,0,0,0,0,0,0,0

#Vehicle Boundaries
0,0,0,0,0,0,0,0,0,0,0,0,0,0,0,0,0,0
0,0,0,0,0,0,0,0,0,0,1,0,1,0,0,0,0,0
0,0,0,0,0,0,0,0,0,0,0,0,0,0,0,0,0,0
0,0,0,0,0,0,0,0,0,0,0,0,0,0,0,0,0,0
0,0,0,0,0,0,0,0,0,0,0,0,1,0,0,0,0,0
0,0,0,0,0,0,1,0,0,0,0,0,0,0,0,0,0,0
0,0,0,0,0,1,0,0,0,0,0,0,0,0,0,0,0,0
0,0,0,0,0,0,0,0,0,0,0,1,0,0,0,0,0,0
0,0,0,0,0,0,0,0,0,0,0,0,0,0,0,0,0,0
0,0,0,0,0,0,0,0,0,0,0,0,0,0,0,0,0,0
0,0,0,0,0,0,0,0,0,0,0,0,0,0,0,0,0,0
0,0,0,0,0,0,0,0,0,0,0,0,0,0,0,0,0,0

#Stages
#Stage Type 0,Map,Mode,Goal,Points,Bonus List(Max 10),Name,End World, then mode settings (see sample tour file for details)
#Stage Type 1,Bonus House Name,Sequential/Random Order,Display Text,Powerup List
10
0,Classicka,0,5,10,0,Stage 1,0
0,Crevice Canyon,0,5,10,0,Stage 2,0
0,Hill,0,5,10,0,Stage 3,0
0,Coal Mine,0,5,10,0,Stage 4,0
0,Castle Wall,0,5,10,0,Stage 5,0
0,Flooded Ghosts,20,30,5,1w6,Flooded Ghost House,0,5,3,2,1
0,Bowsers Castle,0,10,20,0,Final Stage,1
0,MrIslandBattle,0,2,5,1p1,Battle!,0
1,Toad's House,1,|Pick a Powerup To|Help You On Your Way,p1,p5,p11
0,Bonus Room,24,10,5,1p3,Pipe Minigame!,0

#Warps
#location 1 x, y, location 2 x, y
0

#Vehicles
#Sprite,Stage Type, Start Column, Start Row, Min Moves, Max Moves, Sprite Paces, Sprite Direction, Boundary
1
0,7,11,4,5,8,1,0,1

#Initial Items
w4
